method,simnum,subjects,hit,miss,fa,cr,cost,startseed
rw,0,1,73,320,21,12306,341,
goni,0,1,11,382,2,12325,384,
kenett,0,1,14,379,199,12128,578,
fe,0,1,3,390,0,12327,390,
rw,0,2,132,261,49,12278,310,
goni,0,2,33,360,3,12324,363,
kenett,0,2,13,380,305,12022,685,
fe,0,2,6,387,0,12327,387,
rw,0,3,174,219,78,12249,297,
goni,0,3,63,330,11,12316,341,
kenett,0,3,14,379,370,11957,749,
fe,0,3,9,384,0,12327,384,
rw,0,4,210,183,107,12220,290,
goni,0,4,89,304,19,12308,323,
kenett,0,4,12,381,399,11928,780,
fe,0,4,12,381,0,12327,381,
rw,0,5,235,158,131,12196,289,
goni,0,5,113,280,27,12300,307,
kenett,0,5,13,380,407,11920,787,
fe,0,5,15,378,0,12327,378,
rw,0,6,255,138,172,12155,310,
goni,0,6,138,255,36,12291,291,
kenett,0,6,17,376,421,11906,797,
fe,0,6,18,375,0,12327,375,
rw,0,7,271,122,203,12124,325,
goni,0,7,161,232,49,12278,281,
kenett,0,7,16,377,428,11899,805,
fe,0,7,20,373,0,12327,373,
rw,0,8,289,104,236,12091,340,
goni,0,8,181,212,61,12266,273,
kenett,0,8,19,374,428,11899,802,
fe,0,8,22,371,0,12327,371,
rw,0,9,308,85,264,12063,349,
goni,0,9,204,189,68,12259,257,
kenett,0,9,20,373,433,11894,806,
fe,0,9,25,368,0,12327,368,
rw,0,10,323,70,284,12043,354,
goni,0,10,225,168,90,12237,258,
kenett,0,10,21,372,438,11889,810,
fe,0,10,28,365,0,12327,365,
rw,0,11,337,56,309,12018,365,
goni,0,11,242,151,95,12232,246,
kenett,0,11,21,372,447,11880,819,
fe,0,11,31,362,0,12327,362,
rw,0,12,346,47,337,11990,384,
goni,0,12,250,143,117,12210,260,
kenett,0,12,24,369,444,11883,813,
fe,0,12,34,359,0,12327,359,
rw,0,13,359,34,363,11964,397,
goni,0,13,272,121,126,12201,247,
kenett,0,13,34,359,437,11890,796,
fe,0,13,37,356,0,12327,356,
rw,0,14,364,29,388,11939,417,
goni,0,14,282,111,141,12186,252,
kenett,0,14,27,366,444,11883,810,
fe,0,14,40,353,0,12327,353,
rw,0,15,369,24,408,11919,432,
goni,0,15,293,100,158,12169,258,
kenett,0,15,209,184,265,12062,449,
fe,0,15,43,350,0,12327,350,
rw,0,16,370,23,438,11889,461,
goni,0,16,301,92,165,12162,257,
kenett,0,16,213,180,261,12066,441,
fe,0,16,46,347,0,12327,347,
rw,0,17,375,18,454,11873,472,
goni,0,17,312,81,177,12150,258,
kenett,0,17,218,175,256,12071,431,
fe,0,17,48,345,0,12327,345,
rw,0,18,376,17,482,11845,499,
goni,0,18,318,75,177,12150,252,
kenett,0,18,219,174,255,12072,429,
fe,0,18,51,342,0,12327,342,
rw,0,19,378,15,504,11823,519,
goni,0,19,322,71,183,12144,254,
kenett,0,19,223,170,251,12076,421,
fe,0,19,53,340,0,12327,340,
rw,0,20,380,13,531,11796,544,
goni,0,20,331,62,186,12141,248,
kenett,0,20,221,172,253,12074,425,
fe,0,20,56,337,0,12327,337,
rw,0,21,380,13,554,11773,567,
goni,0,21,334,59,201,12126,260,
kenett,0,21,236,157,238,12089,395,
fe,0,21,58,335,0,12327,335,
rw,0,22,381,12,572,11755,584,
goni,0,22,337,56,210,12117,266,
kenett,0,22,235,158,239,12088,397,
fe,0,22,61,332,0,12327,332,
rw,0,23,382,11,595,11732,606,
goni,0,23,340,53,217,12110,270,
kenett,0,23,237,156,237,12090,393,
fe,0,23,64,329,0,12327,329,
rw,0,24,384,9,621,11706,630,
goni,0,24,345,48,234,12093,282,
kenett,0,24,241,152,233,12094,385,
fe,0,24,67,326,0,12327,326,
rw,0,25,387,6,647,11680,653,
goni,0,25,348,45,242,12085,287,
kenett,0,25,243,150,231,12096,381,
fe,0,25,69,324,0,12327,324,
rw,0,26,387,6,673,11654,679,
goni,0,26,350,43,250,12077,293,
kenett,0,26,242,151,232,12095,383,
fe,0,26,71,322,0,12327,322,
rw,0,27,388,5,693,11634,698,
goni,0,27,351,42,247,12080,289,
kenett,0,27,248,145,226,12101,371,
fe,0,27,74,319,0,12327,319,
rw,0,28,390,3,707,11620,710,
goni,0,28,352,41,262,12065,303,
kenett,0,28,247,146,227,12100,373,
fe,0,28,75,318,0,12327,318,
rw,0,29,390,3,726,11601,729,
goni,0,29,355,38,273,12054,311,
kenett,0,29,251,142,223,12104,365,
fe,0,29,78,315,0,12327,315,
rw,0,30,390,3,745,11582,748,
goni,0,30,354,39,291,12036,330,
kenett,0,30,260,133,214,12113,347,
fe,0,30,81,312,0,12327,312,
rw,0,31,390,3,780,11547,783,
goni,0,31,354,39,296,12031,335,
kenett,0,31,255,138,219,12108,357,
fe,0,31,81,312,0,12327,312,
rw,0,32,390,3,803,11524,806,
goni,0,32,359,34,301,12026,335,
kenett,0,32,260,133,214,12113,347,
fe,0,32,82,311,0,12327,311,
rw,0,33,390,3,824,11503,827,
goni,0,33,360,33,309,12018,342,
kenett,0,33,262,131,212,12115,343,
fe,0,33,84,309,0,12327,309,
rw,0,34,391,2,843,11484,845,
goni,0,34,364,29,318,12009,347,
kenett,0,34,260,133,214,12113,347,
fe,0,34,87,306,0,12327,306,
rw,0,35,391,2,863,11464,865,
goni,0,35,365,28,320,12007,348,
kenett,0,35,257,136,217,12110,353,
fe,0,35,90,303,0,12327,303,
rw,0,36,391,2,880,11447,882,
goni,0,36,366,27,330,11997,357,
kenett,0,36,262,131,212,12115,343,
fe,0,36,92,301,0,12327,301,
rw,0,37,391,2,897,11430,899,
goni,0,37,366,27,328,11999,355,
kenett,0,37,260,133,214,12113,347,
fe,0,37,94,299,0,12327,299,
rw,0,38,391,2,912,11415,914,
goni,0,38,368,25,335,11992,360,
kenett,0,38,266,127,208,12119,335,
fe,0,38,96,297,0,12327,297,
rw,0,39,391,2,931,11396,933,
goni,0,39,367,26,334,11993,360,
kenett,0,39,265,128,209,12118,337,
fe,0,39,98,295,0,12327,295,
rw,0,40,392,1,944,11383,945,
goni,0,40,369,24,345,11982,369,
kenett,0,40,266,127,208,12119,335,
fe,0,40,101,292,0,12327,292,
rw,0,41,392,1,966,11361,967,
goni,0,41,370,23,352,11975,375,
kenett,0,41,264,129,210,12117,339,
fe,0,41,104,289,0,12327,289,
rw,0,42,392,1,982,11345,983,
goni,0,42,370,23,358,11969,381,
kenett,0,42,268,125,206,12121,331,
fe,0,42,107,286,0,12327,286,
rw,0,43,392,1,1006,11321,1007,
goni,0,43,374,19,360,11967,379,
kenett,0,43,266,127,208,12119,335,
fe,0,43,110,283,0,12327,283,
rw,0,44,392,1,1024,11303,1025,
goni,0,44,375,18,366,11961,384,
kenett,0,44,260,133,214,12113,347,
fe,0,44,110,283,0,12327,283,
rw,0,45,392,1,1037,11290,1038,
goni,0,45,375,18,382,11945,400,
kenett,0,45,261,132,213,12114,345,
fe,0,45,113,280,0,12327,280,
rw,0,46,392,1,1058,11269,1059,
goni,0,46,376,17,390,11937,407,
kenett,0,46,266,127,208,12119,335,
fe,0,46,115,278,0,12327,278,
rw,0,47,392,1,1076,11251,1077,
goni,0,47,375,18,391,11936,409,
kenett,0,47,268,125,206,12121,331,
fe,0,47,118,275,0,12327,275,
rw,0,48,392,1,1099,11228,1100,
goni,0,48,374,19,393,11934,412,
kenett,0,48,268,125,206,12121,331,
fe,0,48,119,274,0,12327,274,
rw,0,49,392,1,1120,11207,1121,
goni,0,49,377,16,400,11927,416,
kenett,0,49,266,127,208,12119,335,
fe,0,49,121,272,0,12327,272,
rw,0,50,392,1,1137,11190,1138,
goni,0,50,378,15,405,11922,420,
kenett,0,50,272,121,202,12125,323,
fe,0,50,124,269,0,12327,269,
rw,1,1,66,327,29,12298,356,
goni,1,1,9,384,2,12325,386,
kenett,1,1,11,382,190,12137,572,
fe,1,1,3,390,0,12327,390,
rw,1,2,122,271,56,12271,327,
goni,1,2,36,357,7,12320,364,
kenett,1,2,17,376,322,12005,698,
fe,1,2,6,387,0,12327,387,
rw,1,3,164,229,91,12236,320,
goni,1,3,60,333,18,12309,351,
kenett,1,3,20,373,379,11948,752,
fe,1,3,9,384,0,12327,384,
rw,1,4,207,186,119,12208,305,
goni,1,4,84,309,28,12299,337,
kenett,1,4,15,378,420,11907,798,
fe,1,4,12,381,0,12327,381,
rw,1,5,232,161,152,12175,313,
goni,1,5,109,284,36,12291,320,
kenett,1,5,20,373,427,11900,800,
fe,1,5,14,379,0,12327,379,
rw,1,6,261,132,186,12141,318,
goni,1,6,136,257,46,12281,303,
kenett,1,6,21,372,435,11892,807,
fe,1,6,17,376,0,12327,376,
rw,1,7,278,115,215,12112,330,
goni,1,7,162,231,53,12274,284,
kenett,1,7,17,376,445,11882,821,
fe,1,7,20,373,0,12327,373,
rw,1,8,298,95,252,12075,347,
goni,1,8,190,203,69,12258,272,
kenett,1,8,15,378,447,11880,825,
fe,1,8,23,370,0,12327,370,
rw,1,9,311,82,279,12048,361,
goni,1,9,200,193,70,12257,263,
kenett,1,9,177,216,297,12030,513,
fe,1,9,26,367,0,12327,367,
rw,1,10,322,71,298,12029,369,
goni,1,10,223,170,91,12236,261,
kenett,1,10,181,212,293,12034,505,
fe,1,10,29,364,0,12327,364,
rw,1,11,335,58,320,12007,378,
goni,1,11,233,160,95,12232,255,
kenett,1,11,188,205,286,12041,491,
fe,1,11,32,361,0,12327,361,
rw,1,12,344,49,343,11984,392,
goni,1,12,243,150,106,12221,256,
kenett,1,12,199,194,275,12052,469,
fe,1,12,35,358,0,12327,358,
rw,1,13,351,42,383,11944,425,
goni,1,13,265,128,121,12206,249,
kenett,1,13,205,188,269,12058,457,
fe,1,13,37,356,0,12327,356,
rw,1,14,361,32,413,11914,445,
goni,1,14,275,118,150,12177,268,
kenett,1,14,207,186,267,12060,453,
fe,1,14,40,353,0,12327,353,
rw,1,15,367,26,441,11886,467,
goni,1,15,286,107,147,12180,254,
kenett,1,15,215,178,259,12068,437,
fe,1,15,42,351,0,12327,351,
rw,1,16,372,21,470,11857,491,
goni,1,16,295,98,162,12165,260,
kenett,1,16,224,169,250,12077,419,
fe,1,16,45,348,0,12327,348,
rw,1,17,375,18,491,11836,509,
goni,1,17,306,87,178,12149,265,
kenett,1,17,224,169,250,12077,419,
fe,1,17,48,345,0,12327,345,
rw,1,18,377,16,512,11815,528,
goni,1,18,305,88,181,12146,269,
kenett,1,18,231,162,243,12084,405,
fe,1,18,50,343,0,12327,343,
rw,1,19,380,13,535,11792,548,
goni,1,19,311,82,188,12139,270,
kenett,1,19,229,164,245,12082,409,
fe,1,19,52,341,0,12327,341,
rw,1,20,380,13,556,11771,569,
goni,1,20,322,71,196,12131,267,
kenett,1,20,237,156,237,12090,393,
fe,1,20,55,338,0,12327,338,
rw,1,21,381,12,574,11753,586,
goni,1,21,324,69,205,12122,274,
kenett,1,21,247,146,227,12100,373,
fe,1,21,58,335,0,12327,335,
rw,1,22,383,10,593,11734,603,
goni,1,22,324,69,206,12121,275,
kenett,1,22,246,147,228,12099,375,
fe,1,22,61,332,0,12327,332,
rw,1,23,383,10,616,11711,626,
goni,1,23,330,63,223,12104,286,
kenett,1,23,243,150,231,12096,381,
fe,1,23,63,330,0,12327,330,
rw,1,24,384,9,633,11694,642,
goni,1,24,334,59,229,12098,288,
kenett,1,24,240,153,234,12093,387,
fe,1,24,65,328,0,12327,328,
rw,1,25,384,9,656,11671,665,
goni,1,25,334,59,237,12090,296,
kenett,1,25,240,153,234,12093,387,
fe,1,25,67,326,0,12327,326,
rw,1,26,385,8,677,11650,685,
goni,1,26,339,54,253,12074,307,
kenett,1,26,247,146,227,12100,373,
fe,1,26,69,324,0,12327,324,
rw,1,27,386,7,697,11630,704,
goni,1,27,347,46,256,12071,302,
kenett,1,27,246,147,228,12099,375,
fe,1,27,72,321,0,12327,321,
rw,1,28,387,6,724,11603,730,
goni,1,28,353,40,269,12058,309,
kenett,1,28,252,141,222,12105,363,
fe,1,28,74,319,0,12327,319,
rw,1,29,388,5,748,11579,753,
goni,1,29,354,39,286,12041,325,
kenett,1,29,257,136,217,12110,353,
fe,1,29,76,317,0,12327,317,
rw,1,30,388,5,770,11557,775,
goni,1,30,358,35,292,12035,327,
kenett,1,30,261,132,213,12114,345,
fe,1,30,76,317,0,12327,317,
rw,1,31,388,5,790,11537,795,
goni,1,31,360,33,300,12027,333,
kenett,1,31,261,132,213,12114,345,
fe,1,31,78,315,0,12327,315,
rw,1,32,389,4,809,11518,813,
goni,1,32,362,31,297,12030,328,
kenett,1,32,257,136,217,12110,353,
fe,1,32,81,312,0,12327,312,
rw,1,33,389,4,829,11498,833,
goni,1,33,364,29,302,12025,331,
kenett,1,33,265,128,209,12118,337,
fe,1,33,82,311,0,12327,311,
rw,1,34,389,4,847,11480,851,
goni,1,34,366,27,306,12021,333,
kenett,1,34,265,128,209,12118,337,
fe,1,34,84,309,0,12327,309,
rw,1,35,389,4,869,11458,873,
goni,1,35,365,28,314,12013,342,
kenett,1,35,257,136,217,12110,353,
fe,1,35,87,306,0,12327,306,
rw,1,36,389,4,891,11436,895,
goni,1,36,367,26,321,12006,347,
kenett,1,36,260,133,214,12113,347,
fe,1,36,90,303,0,12327,303,
rw,1,37,389,4,910,11417,914,
goni,1,37,368,25,329,11998,354,
kenett,1,37,256,137,218,12109,355,
fe,1,37,93,300,0,12327,300,
rw,1,38,389,4,925,11402,929,
goni,1,38,370,23,335,11992,358,
kenett,1,38,254,139,220,12107,359,
fe,1,38,95,298,0,12327,298,
rw,1,39,389,4,940,11387,944,
goni,1,39,371,22,344,11983,366,
kenett,1,39,254,139,220,12107,359,
fe,1,39,98,295,0,12327,295,
rw,1,40,389,4,954,11373,958,
goni,1,40,373,20,346,11981,366,
kenett,1,40,257,136,217,12110,353,
fe,1,40,99,294,0,12327,294,
rw,1,41,389,4,976,11351,980,
goni,1,41,373,20,345,11982,365,
kenett,1,41,259,134,215,12112,349,
fe,1,41,101,292,0,12327,292,
rw,1,42,389,4,1002,11325,1006,
goni,1,42,375,18,364,11963,382,
kenett,1,42,263,130,211,12116,341,
fe,1,42,102,291,0,12327,291,
rw,1,43,389,4,1024,11303,1028,
goni,1,43,376,17,368,11959,385,
kenett,1,43,275,118,199,12128,317,
fe,1,43,105,288,0,12327,288,
rw,1,44,389,4,1036,11291,1040,
goni,1,44,378,15,372,11955,387,
kenett,1,44,269,124,205,12122,329,
fe,1,44,107,286,0,12327,286,
rw,1,45,390,3,1054,11273,1057,
goni,1,45,377,16,379,11948,395,
kenett,1,45,272,121,202,12125,323,
fe,1,45,109,284,0,12327,284,
rw,1,46,390,3,1070,11257,1073,
goni,1,46,375,18,392,11935,410,
kenett,1,46,278,115,196,12131,311,
fe,1,46,112,281,0,12327,281,
rw,1,47,390,3,1085,11242,1088,
goni,1,47,375,18,405,11922,423,
kenett,1,47,275,118,199,12128,317,
fe,1,47,115,278,0,12327,278,
rw,1,48,391,2,1100,11227,1102,
goni,1,48,376,17,412,11915,429,
kenett,1,48,274,119,200,12127,319,
fe,1,48,117,276,0,12327,276,
rw,1,49,391,2,1119,11208,1121,
goni,1,49,377,16,421,11906,437,
kenett,1,49,272,121,202,12125,323,
fe,1,49,119,274,0,12327,274,
rw,1,50,391,2,1138,11189,1140,
goni,1,50,376,17,420,11907,437,
kenett,1,50,276,117,198,12129,315,
fe,1,50,120,273,0,12327,273,
rw,2,1,71,322,29,12298,351,
goni,2,1,4,389,0,12327,389,
kenett,2,1,9,384,228,12099,612,
fe,2,1,3,390,0,12327,390,
rw,2,2,134,259,47,12280,306,
goni,2,2,34,359,7,12320,366,
kenett,2,2,18,375,321,12006,696,
fe,2,2,6,387,0,12327,387,
rw,2,3,184,209,73,12254,282,
goni,2,3,64,329,17,12310,346,
kenett,2,3,20,373,373,11954,746,
fe,2,3,9,384,0,12327,384,
rw,2,4,222,171,109,12218,280,
goni,2,4,91,302,19,12308,321,
kenett,2,4,20,373,421,11906,794,
fe,2,4,12,381,0,12327,381,
rw,2,5,244,149,138,12189,287,
goni,2,5,117,276,34,12293,310,
kenett,2,5,15,378,441,11886,819,
fe,2,5,14,379,0,12327,379,
rw,2,6,264,129,172,12155,301,
goni,2,6,142,251,45,12282,296,
kenett,2,6,29,364,430,11897,794,
fe,2,6,17,376,0,12327,376,
rw,2,7,280,113,201,12126,314,
goni,2,7,172,221,58,12269,279,
kenett,2,7,21,372,438,11889,810,
fe,2,7,20,373,0,12327,373,
rw,2,8,303,90,236,12091,326,
goni,2,8,195,198,76,12251,274,
kenett,2,8,21,372,441,11886,813,
fe,2,8,23,370,0,12327,370,
rw,2,9,323,70,264,12063,334,
goni,2,9,213,180,82,12245,262,
kenett,2,9,16,377,449,11878,826,
fe,2,9,25,368,0,12327,368,
rw,2,10,328,65,297,12030,362,
goni,2,10,237,156,89,12238,245,
kenett,2,10,12,381,453,11874,834,
fe,2,10,27,366,0,12327,366,
rw,2,11,335,58,324,12003,382,
goni,2,11,248,145,95,12232,240,
kenett,2,11,17,376,448,11879,824,
fe,2,11,29,364,0,12327,364,
rw,2,12,343,50,346,11981,396,
goni,2,12,259,134,118,12209,252,
kenett,2,12,28,365,443,11884,808,
fe,2,12,32,361,0,12327,361,
rw,2,13,354,39,370,11957,409,
goni,2,13,269,124,141,12186,265,
kenett,2,13,31,362,440,11887,802,
fe,2,13,35,358,0,12327,358,
rw,2,14,357,36,396,11931,432,
goni,2,14,281,112,156,12171,268,
kenett,2,14,29,364,442,11885,806,
fe,2,14,38,355,0,12327,355,
rw,2,15,367,26,416,11911,442,
goni,2,15,293,100,169,12158,269,
kenett,2,15,32,361,439,11888,800,
fe,2,15,40,353,0,12327,353,
rw,2,16,368,25,444,11883,469,
goni,2,16,303,90,172,12155,262,
kenett,2,16,31,362,440,11887,802,
fe,2,16,42,351,0,12327,351,
rw,2,17,376,17,470,11857,487,
goni,2,17,307,86,183,12144,269,
kenett,2,17,33,360,438,11889,798,
fe,2,17,45,348,0,12327,348,
rw,2,18,379,14,497,11830,511,
goni,2,18,321,72,193,12134,265,
kenett,2,18,27,366,444,11883,810,
fe,2,18,47,346,0,12327,346,
rw,2,19,381,12,522,11805,534,
goni,2,19,325,68,204,12123,272,
kenett,2,19,40,353,431,11896,784,
fe,2,19,50,343,0,12327,343,
rw,2,20,382,11,556,11771,567,
goni,2,20,325,68,204,12123,272,
kenett,2,20,228,165,246,12081,411,
fe,2,20,52,341,0,12327,341,
rw,2,21,384,9,578,11749,587,
goni,2,21,331,62,216,12111,278,
kenett,2,21,232,161,242,12085,403,
fe,2,21,55,338,0,12327,338,
rw,2,22,387,6,605,11722,611,
goni,2,22,331,62,217,12110,279,
kenett,2,22,239,154,235,12092,389,
fe,2,22,57,336,0,12327,336,
rw,2,23,389,4,620,11707,624,
goni,2,23,338,55,232,12095,287,
kenett,2,23,241,152,233,12094,385,
fe,2,23,58,335,0,12327,335,
rw,2,24,389,4,637,11690,641,
goni,2,24,343,50,238,12089,288,
kenett,2,24,235,158,239,12088,397,
fe,2,24,61,332,0,12327,332,
rw,2,25,389,4,665,11662,669,
goni,2,25,344,49,239,12088,288,
kenett,2,25,244,149,230,12097,379,
fe,2,25,64,329,0,12327,329,
rw,2,26,389,4,687,11640,691,
goni,2,26,348,45,256,12071,301,
kenett,2,26,250,143,224,12103,367,
fe,2,26,65,328,0,12327,328,
rw,2,27,389,4,703,11624,707,
goni,2,27,352,41,261,12066,302,
kenett,2,27,246,147,228,12099,375,
fe,2,27,67,326,0,12327,326,
rw,2,28,390,3,720,11607,723,
goni,2,28,352,41,266,12061,307,
kenett,2,28,259,134,215,12112,349,
fe,2,28,70,323,0,12327,323,
rw,2,29,392,1,748,11579,749,
goni,2,29,352,41,276,12051,317,
kenett,2,29,248,145,226,12101,371,
fe,2,29,72,321,0,12327,321,
rw,2,30,392,1,761,11566,762,
goni,2,30,354,39,284,12043,323,
kenett,2,30,250,143,224,12103,367,
fe,2,30,75,318,0,12327,318,
rw,2,31,392,1,780,11547,781,
goni,2,31,358,35,290,12037,325,
kenett,2,31,263,130,211,12116,341,
fe,2,31,78,315,0,12327,315,
rw,2,32,392,1,799,11528,800,
goni,2,32,363,30,306,12021,336,
kenett,2,32,260,133,214,12113,347,
fe,2,32,81,312,0,12327,312,
rw,2,33,392,1,821,11506,822,
goni,2,33,364,29,302,12025,331,
kenett,2,33,269,124,205,12122,329,
fe,2,33,84,309,0,12327,309,
rw,2,34,392,1,843,11484,844,
goni,2,34,367,26,311,12016,337,
kenett,2,34,260,133,214,12113,347,
fe,2,34,87,306,0,12327,306,
rw,2,35,392,1,864,11463,865,
goni,2,35,366,27,316,12011,343,
kenett,2,35,267,126,207,12120,333,
fe,2,35,90,303,0,12327,303,
rw,2,36,392,1,885,11442,886,
goni,2,36,365,28,325,12002,353,
kenett,2,36,267,126,207,12120,333,
fe,2,36,92,301,0,12327,301,
rw,2,37,392,1,909,11418,910,
goni,2,37,367,26,337,11990,363,
kenett,2,37,271,122,203,12124,325,
fe,2,37,95,298,0,12327,298,
rw,2,38,392,1,931,11396,932,
goni,2,38,370,23,344,11983,367,
kenett,2,38,270,123,204,12123,327,
fe,2,38,97,296,0,12327,296,
rw,2,39,392,1,949,11378,950,
goni,2,39,368,25,357,11970,382,
kenett,2,39,270,123,204,12123,327,
fe,2,39,99,294,0,12327,294,
rw,2,40,392,1,965,11362,966,
goni,2,40,371,22,374,11953,396,
kenett,2,40,271,122,203,12124,325,
fe,2,40,101,292,0,12327,292,
rw,2,41,392,1,975,11352,976,
goni,2,41,373,20,380,11947,400,
kenett,2,41,270,123,204,12123,327,
fe,2,41,104,289,0,12327,289,
rw,2,42,392,1,989,11338,990,
goni,2,42,373,20,389,11938,409,
kenett,2,42,278,115,196,12131,311,
fe,2,42,106,287,0,12327,287,
rw,2,43,392,1,1008,11319,1009,
goni,2,43,375,18,397,11930,415,
kenett,2,43,277,116,197,12130,313,
fe,2,43,108,285,0,12327,285,
rw,2,44,392,1,1029,11298,1030,
goni,2,44,375,18,399,11928,417,
kenett,2,44,278,115,196,12131,311,
fe,2,44,111,282,0,12327,282,
rw,2,45,392,1,1047,11280,1048,
goni,2,45,377,16,401,11926,417,
kenett,2,45,274,119,200,12127,319,
fe,2,45,113,280,0,12327,280,
rw,2,46,392,1,1060,11267,1061,
goni,2,46,377,16,400,11927,416,
kenett,2,46,270,123,204,12123,327,
fe,2,46,114,279,0,12327,279,
rw,2,47,393,0,1082,11245,1082,
goni,2,47,378,15,407,11920,422,
kenett,2,47,281,112,193,12134,305,
fe,2,47,116,277,0,12327,277,
rw,2,48,393,0,1103,11224,1103,
goni,2,48,378,15,409,11918,424,
kenett,2,48,282,111,192,12135,303,
fe,2,48,117,276,0,12327,276,
rw,2,49,393,0,1123,11204,1123,
goni,2,49,378,15,416,11911,431,
kenett,2,49,279,114,195,12132,309,
fe,2,49,120,273,0,12327,273,
rw,2,50,393,0,1141,11186,1141,
goni,2,50,377,16,429,11898,445,
kenett,2,50,289,104,185,12142,289,
fe,2,50,123,270,0,12327,270,
rw,3,1,63,330,33,12294,363,
goni,3,1,9,384,5,12322,389,
kenett,3,1,7,386,200,12127,586,
fe,3,1,3,390,0,12327,390,
rw,3,2,120,273,64,12263,337,
goni,3,2,34,359,13,12314,372,
kenett,3,2,15,378,318,12009,696,
fe,3,2,6,387,0,12327,387,
rw,3,3,173,220,90,12237,310,
goni,3,3,65,328,22,12305,350,
kenett,3,3,14,379,379,11948,758,
fe,3,3,9,384,0,12327,384,
rw,3,4,214,179,113,12214,292,
goni,3,4,101,292,29,12298,321,
kenett,3,4,16,377,413,11914,790,
fe,3,4,11,382,0,12327,382,
rw,3,5,235,158,151,12176,309,
goni,3,5,124,269,42,12285,311,
kenett,3,5,18,375,426,11901,801,
fe,3,5,14,379,0,12327,379,
rw,3,6,262,131,177,12150,308,
goni,3,6,155,238,49,12278,287,
kenett,3,6,17,376,436,11891,812,
fe,3,6,16,377,0,12327,377,
rw,3,7,285,108,212,12115,320,
goni,3,7,173,220,61,12266,281,
kenett,3,7,23,370,442,11885,812,
fe,3,7,19,374,0,12327,374,
rw,3,8,301,92,236,12091,328,
goni,3,8,186,207,72,12255,279,
kenett,3,8,24,369,441,11886,810,
fe,3,8,22,371,0,12327,371,
rw,3,9,313,80,264,12063,344,
goni,3,9,207,186,82,12245,268,
kenett,3,9,23,370,442,11885,812,
fe,3,9,25,368,0,12327,368,
rw,3,10,325,68,293,12034,361,
goni,3,10,222,171,98,12229,269,
kenett,3,10,40,353,431,11896,784,
fe,3,10,27,366,0,12327,366,
rw,3,11,331,62,326,12001,388,
goni,3,11,228,165,106,12221,271,
kenett,3,11,40,353,431,11896,784,
fe,3,11,30,363,0,12327,363,
rw,3,12,342,51,349,11978,400,
goni,3,12,239,154,123,12204,277,
kenett,3,12,37,356,434,11893,790,
fe,3,12,32,361,0,12327,361,
rw,3,13,349,44,375,11952,419,
goni,3,13,252,141,134,12193,275,
kenett,3,13,35,358,436,11891,794,
fe,3,13,35,358,0,12327,358,
rw,3,14,355,38,401,11926,439,
goni,3,14,272,121,146,12181,267,
kenett,3,14,193,200,281,12046,481,
fe,3,14,38,355,0,12327,355,
rw,3,15,360,33,430,11897,463,
goni,3,15,283,110,149,12178,259,
kenett,3,15,193,200,281,12046,481,
fe,3,15,41,352,0,12327,352,
rw,3,16,368,25,454,11873,479,
goni,3,16,297,96,165,12162,261,
kenett,3,16,206,187,268,12059,455,
fe,3,16,44,349,0,12327,349,
rw,3,17,373,20,475,11852,495,
goni,3,17,311,82,181,12146,263,
kenett,3,17,210,183,264,12063,447,
fe,3,17,47,346,0,12327,346,
rw,3,18,378,15,499,11828,514,
goni,3,18,313,80,183,12144,263,
kenett,3,18,213,180,261,12066,441,
fe,3,18,50,343,0,12327,343,
rw,3,19,379,14,526,11801,540,
goni,3,19,316,77,192,12135,269,
kenett,3,19,217,176,257,12070,433,
fe,3,19,52,341,0,12327,341,
rw,3,20,380,13,552,11775,565,
goni,3,20,320,73,199,12128,272,
kenett,3,20,230,163,244,12083,407,
fe,3,20,55,338,0,12327,338,
rw,3,21,384,9,570,11757,579,
goni,3,21,325,68,210,12117,278,
kenett,3,21,232,161,242,12085,403,
fe,3,21,57,336,0,12327,336,
rw,3,22,385,8,598,11729,606,
goni,3,22,332,61,212,12115,273,
kenett,3,22,235,158,239,12088,397,
fe,3,22,58,335,0,12327,335,
rw,3,23,386,7,624,11703,631,
goni,3,23,334,59,222,12105,281,
kenett,3,23,234,159,240,12087,399,
fe,3,23,60,333,0,12327,333,
rw,3,24,386,7,649,11678,656,
goni,3,24,334,59,238,12089,297,
kenett,3,24,232,161,242,12085,403,
fe,3,24,63,330,0,12327,330,
rw,3,25,387,6,663,11664,669,
goni,3,25,336,57,244,12083,301,
kenett,3,25,238,155,236,12091,391,
fe,3,25,65,328,0,12327,328,
rw,3,26,387,6,680,11647,686,
goni,3,26,340,53,257,12070,310,
kenett,3,26,245,148,229,12098,377,
fe,3,26,67,326,0,12327,326,
rw,3,27,388,5,704,11623,709,
goni,3,27,347,46,266,12061,312,
kenett,3,27,239,154,235,12092,389,
fe,3,27,70,323,0,12327,323,
rw,3,28,388,5,722,11605,727,
goni,3,28,347,46,272,12055,318,
kenett,3,28,243,150,231,12096,381,
fe,3,28,72,321,0,12327,321,
rw,3,29,388,5,746,11581,751,
goni,3,29,349,44,275,12052,319,
kenett,3,29,240,153,234,12093,387,
fe,3,29,75,318,0,12327,318,
rw,3,30,389,4,762,11565,766,
goni,3,30,351,42,286,12041,328,
kenett,3,30,251,142,223,12104,365,
fe,3,30,76,317,0,12327,317,
rw,3,31,389,4,788,11539,792,
goni,3,31,354,39,294,12033,333,
kenett,3,31,247,146,227,12100,373,
fe,3,31,79,314,0,12327,314,
rw,3,32,390,3,808,11519,811,
goni,3,32,357,36,295,12032,331,
kenett,3,32,248,145,226,12101,371,
fe,3,32,82,311,0,12327,311,
rw,3,33,390,3,824,11503,827,
goni,3,33,360,33,299,12028,332,
kenett,3,33,249,144,225,12102,369,
fe,3,33,85,308,0,12327,308,
rw,3,34,390,3,845,11482,848,
goni,3,34,361,32,312,12015,344,
kenett,3,34,248,145,226,12101,371,
fe,3,34,88,305,0,12327,305,
rw,3,35,390,3,867,11460,870,
goni,3,35,362,31,325,12002,356,
kenett,3,35,253,140,221,12106,361,
fe,3,35,90,303,0,12327,303,
rw,3,36,390,3,888,11439,891,
goni,3,36,362,31,329,11998,360,
kenett,3,36,256,137,218,12109,355,
fe,3,36,93,300,0,12327,300,
rw,3,37,390,3,899,11428,902,
goni,3,37,365,28,339,11988,367,
kenett,3,37,251,142,223,12104,365,
fe,3,37,96,297,0,12327,297,
rw,3,38,390,3,916,11411,919,
goni,3,38,365,28,340,11987,368,
kenett,3,38,259,134,215,12112,349,
fe,3,38,99,294,0,12327,294,
rw,3,39,390,3,930,11397,933,
goni,3,39,368,25,342,11985,367,
kenett,3,39,260,133,214,12113,347,
fe,3,39,101,292,0,12327,292,
rw,3,40,390,3,947,11380,950,
goni,3,40,369,24,349,11978,373,
kenett,3,40,261,132,213,12114,345,
fe,3,40,104,289,0,12327,289,
rw,3,41,390,3,968,11359,971,
goni,3,41,369,24,361,11966,385,
kenett,3,41,262,131,212,12115,343,
fe,3,41,105,288,0,12327,288,
rw,3,42,390,3,985,11342,988,
goni,3,42,368,25,366,11961,391,
kenett,3,42,266,127,208,12119,335,
fe,3,42,107,286,0,12327,286,
rw,3,43,390,3,1008,11319,1011,
goni,3,43,370,23,368,11959,391,
kenett,3,43,269,124,205,12122,329,
fe,3,43,109,284,0,12327,284,
rw,3,44,390,3,1024,11303,1027,
goni,3,44,372,21,374,11953,395,
kenett,3,44,271,122,203,12124,325,
fe,3,44,111,282,0,12327,282,
rw,3,45,390,3,1035,11292,1038,
goni,3,45,372,21,378,11949,399,
kenett,3,45,270,123,204,12123,327,
fe,3,45,113,280,0,12327,280,
rw,3,46,390,3,1055,11272,1058,
goni,3,46,371,22,389,11938,411,
kenett,3,46,270,123,204,12123,327,
fe,3,46,115,278,0,12327,278,
rw,3,47,391,2,1074,11253,1076,
goni,3,47,375,18,391,11936,409,
kenett,3,47,265,128,209,12118,337,
fe,3,47,116,277,0,12327,277,
rw,3,48,391,2,1089,11238,1091,
goni,3,48,375,18,395,11932,413,
kenett,3,48,273,120,201,12126,321,
fe,3,48,118,275,0,12327,275,
rw,3,49,392,1,1107,11220,1108,
goni,3,49,374,19,394,11933,413,
kenett,3,49,272,121,202,12125,323,
fe,3,49,120,273,0,12327,273,
rw,3,50,393,0,1125,11202,1125,
goni,3,50,375,18,405,11922,423,
kenett,3,50,266,127,208,12119,335,
fe,3,50,121,272,0,12327,272,
rw,4,1,69,324,30,12297,354,
goni,4,1,5,388,3,12324,391,
kenett,4,1,9,384,201,12126,585,
fe,4,1,3,390,0,12327,390,
rw,4,2,126,267,51,12276,318,
goni,4,2,33,360,7,12320,367,
kenett,4,2,20,373,298,12029,671,
fe,4,2,6,387,0,12327,387,
rw,4,3,173,220,85,12242,305,
goni,4,3,58,335,11,12316,346,
kenett,4,3,13,380,380,11947,760,
fe,4,3,9,384,0,12327,384,
rw,4,4,206,187,112,12215,299,
goni,4,4,89,304,22,12305,326,
kenett,4,4,14,379,403,11924,782,
fe,4,4,12,381,0,12327,381,
rw,4,5,230,163,143,12184,306,
goni,4,5,117,276,39,12288,315,
kenett,4,5,12,381,411,11916,792,
fe,4,5,13,380,0,12327,380,
rw,4,6,256,137,168,12159,305,
goni,4,6,136,257,46,12281,303,
kenett,4,6,15,378,423,11904,801,
fe,4,6,15,378,0,12327,378,
rw,4,7,274,119,202,12125,321,
goni,4,7,165,228,63,12264,291,
kenett,4,7,13,380,434,11893,814,
fe,4,7,18,375,0,12327,375,
rw,4,8,291,102,221,12106,323,
goni,4,8,180,213,69,12258,282,
kenett,4,8,18,375,441,11886,816,
fe,4,8,21,372,0,12327,372,
rw,4,9,311,82,245,12082,327,
goni,4,9,204,189,84,12243,273,
kenett,4,9,19,374,449,11878,823,
fe,4,9,24,369,0,12327,369,
rw,4,10,322,71,272,12055,343,
goni,4,10,230,163,100,12227,263,
kenett,4,10,29,364,442,11885,806,
fe,4,10,26,367,0,12327,367,
rw,4,11,336,57,302,12025,359,
goni,4,11,234,159,110,12217,269,
kenett,4,11,167,226,307,12020,533,
fe,4,11,29,364,0,12327,364,
rw,4,12,346,47,332,11995,379,
goni,4,12,249,144,126,12201,270,
kenett,4,12,176,217,298,12029,515,
fe,4,12,31,362,0,12327,362,
rw,4,13,357,36,363,11964,399,
goni,4,13,266,127,145,12182,272,
kenett,4,13,189,204,285,12042,489,
fe,4,13,34,359,0,12327,359,
rw,4,14,366,27,385,11942,412,
goni,4,14,285,108,159,12168,267,
kenett,4,14,193,200,281,12046,481,
fe,4,14,36,357,0,12327,357,
rw,4,15,368,25,412,11915,437,
goni,4,15,293,100,161,12166,261,
kenett,4,15,199,194,275,12052,469,
fe,4,15,39,354,0,12327,354,
rw,4,16,373,20,437,11890,457,
goni,4,16,299,94,177,12150,271,
kenett,4,16,204,189,270,12057,459,
fe,4,16,42,351,0,12327,351,
rw,4,17,375,18,454,11873,472,
goni,4,17,307,86,186,12141,272,
kenett,4,17,206,187,268,12059,455,
fe,4,17,44,349,0,12327,349,
rw,4,18,378,15,481,11846,496,
goni,4,18,311,82,191,12136,273,
kenett,4,18,214,179,260,12067,439,
fe,4,18,47,346,0,12327,346,
rw,4,19,378,15,510,11817,525,
goni,4,19,318,75,203,12124,278,
kenett,4,19,218,175,256,12071,431,
fe,4,19,49,344,0,12327,344,
rw,4,20,381,12,528,11799,540,
goni,4,20,322,71,209,12118,280,
kenett,4,20,217,176,257,12070,433,
fe,4,20,52,341,0,12327,341,
rw,4,21,383,10,549,11778,559,
goni,4,21,327,66,216,12111,282,
kenett,4,21,214,179,260,12067,439,
fe,4,21,55,338,0,12327,338,
rw,4,22,383,10,574,11753,584,
goni,4,22,334,59,222,12105,281,
kenett,4,22,223,170,251,12076,421,
fe,4,22,58,335,0,12327,335,
rw,4,23,383,10,598,11729,608,
goni,4,23,336,57,224,12103,281,
kenett,4,23,231,162,243,12084,405,
fe,4,23,60,333,0,12327,333,
rw,4,24,383,10,620,11707,630,
goni,4,24,345,48,225,12102,273,
kenett,4,24,230,163,244,12083,407,
fe,4,24,62,331,0,12327,331,
rw,4,25,384,9,646,11681,655,
goni,4,25,348,45,235,12092,280,
kenett,4,25,236,157,238,12089,395,
fe,4,25,64,329,0,12327,329,
rw,4,26,385,8,659,11668,667,
goni,4,26,353,40,243,12084,283,
kenett,4,26,234,159,240,12087,399,
fe,4,26,65,328,0,12327,328,
rw,4,27,387,6,679,11648,685,
goni,4,27,357,36,254,12073,290,
kenett,4,27,234,159,240,12087,399,
fe,4,27,68,325,0,12327,325,
rw,4,28,387,6,704,11623,710,
goni,4,28,360,33,269,12058,302,
kenett,4,28,235,158,239,12088,397,
fe,4,28,70,323,0,12327,323,
rw,4,29,388,5,721,11606,726,
goni,4,29,362,31,273,12054,304,
kenett,4,29,244,149,230,12097,379,
fe,4,29,73,320,0,12327,320,
rw,4,30,388,5,746,11581,751,
goni,4,30,361,32,280,12047,312,
kenett,4,30,246,147,228,12099,375,
fe,4,30,74,319,0,12327,319,
rw,4,31,388,5,763,11564,768,
goni,4,31,362,31,286,12041,317,
kenett,4,31,241,152,233,12094,385,
fe,4,31,76,317,0,12327,317,
rw,4,32,389,4,781,11546,785,
goni,4,32,364,29,291,12036,320,
kenett,4,32,246,147,228,12099,375,
fe,4,32,78,315,0,12327,315,
rw,4,33,391,2,804,11523,806,
goni,4,33,367,26,295,12032,321,
kenett,4,33,251,142,223,12104,365,
fe,4,33,79,314,0,12327,314,
rw,4,34,392,1,817,11510,818,
goni,4,34,366,27,299,12028,326,
kenett,4,34,245,148,229,12098,377,
fe,4,34,81,312,0,12327,312,
rw,4,35,392,1,844,11483,845,
goni,4,35,370,23,299,12028,322,
kenett,4,35,250,143,224,12103,367,
fe,4,35,83,310,0,12327,310,
rw,4,36,392,1,858,11469,859,
goni,4,36,372,21,305,12022,326,
kenett,4,36,251,142,223,12104,365,
fe,4,36,86,307,0,12327,307,
rw,4,37,392,1,879,11448,880,
goni,4,37,372,21,300,12027,321,
kenett,4,37,256,137,218,12109,355,
fe,4,37,87,306,0,12327,306,
rw,4,38,392,1,893,11434,894,
goni,4,38,376,17,309,12018,326,
kenett,4,38,256,137,218,12109,355,
fe,4,38,90,303,0,12327,303,
rw,4,39,393,0,908,11419,908,
goni,4,39,377,16,314,12013,330,
kenett,4,39,260,133,214,12113,347,
fe,4,39,91,302,0,12327,302,
rw,4,40,393,0,924,11403,924,
goni,4,40,376,17,329,11998,346,
kenett,4,40,261,132,213,12114,345,
fe,4,40,93,300,0,12327,300,
rw,4,41,393,0,950,11377,950,
goni,4,41,378,15,336,11991,351,
kenett,4,41,264,129,210,12117,339,
fe,4,41,95,298,0,12327,298,
rw,4,42,393,0,978,11349,978,
goni,4,42,380,13,353,11974,366,
kenett,4,42,266,127,208,12119,335,
fe,4,42,97,296,0,12327,296,
rw,4,43,393,0,995,11332,995,
goni,4,43,382,11,359,11968,370,
kenett,4,43,263,130,211,12116,341,
fe,4,43,99,294,0,12327,294,
rw,4,44,393,0,1004,11323,1004,
goni,4,44,382,11,371,11956,382,
kenett,4,44,264,129,210,12117,339,
fe,4,44,101,292,0,12327,292,
rw,4,45,393,0,1020,11307,1020,
goni,4,45,382,11,379,11948,390,
kenett,4,45,265,128,209,12118,337,
fe,4,45,102,291,0,12327,291,
rw,4,46,393,0,1038,11289,1038,
goni,4,46,382,11,387,11940,398,
kenett,4,46,271,122,203,12124,325,
fe,4,46,103,290,0,12327,290,
rw,4,47,393,0,1050,11277,1050,
goni,4,47,381,12,384,11943,396,
kenett,4,47,265,128,209,12118,337,
fe,4,47,105,288,0,12327,288,
rw,4,48,393,0,1067,11260,1067,
goni,4,48,385,8,394,11933,402,
kenett,4,48,265,128,209,12118,337,
fe,4,48,106,287,0,12327,287,
rw,4,49,393,0,1089,11238,1089,
goni,4,49,385,8,393,11934,401,
kenett,4,49,270,123,204,12123,327,
fe,4,49,107,286,0,12327,286,
rw,4,50,393,0,1108,11219,1108,
goni,4,50,384,9,393,11934,402,
kenett,4,50,272,121,202,12125,323,
fe,4,50,108,285,0,12327,285,
rw,5,1,67,326,30,12297,356,
goni,5,1,9,384,2,12325,386,
kenett,5,1,11,382,223,12104,605,
fe,5,1,3,390,0,12327,390,
rw,5,2,124,269,58,12269,327,
goni,5,2,32,361,6,12321,367,
kenett,5,2,11,382,343,11984,725,
fe,5,2,6,387,0,12327,387,
rw,5,3,170,223,85,12242,308,
goni,5,3,73,320,17,12310,337,
kenett,5,3,10,383,404,11923,787,
fe,5,3,9,384,0,12327,384,
rw,5,4,208,185,112,12215,297,
goni,5,4,97,296,25,12302,321,
kenett,5,4,17,376,430,11897,806,
fe,5,4,12,381,0,12327,381,
rw,5,5,245,148,142,12185,290,
goni,5,5,130,263,37,12290,300,
kenett,5,5,16,377,440,11887,817,
fe,5,5,15,378,0,12327,378,
rw,5,6,280,113,162,12165,275,
goni,5,6,164,229,50,12277,279,
kenett,5,6,21,372,441,11886,813,
fe,5,6,17,376,0,12327,376,
rw,5,7,294,99,196,12131,295,
goni,5,7,195,198,62,12265,260,
kenett,5,7,21,372,444,11883,816,
fe,5,7,20,373,0,12327,373,
rw,5,8,304,89,219,12108,308,
goni,5,8,205,188,77,12250,265,
kenett,5,8,21,372,444,11883,816,
fe,5,8,23,370,0,12327,370,
rw,5,9,314,79,249,12078,328,
goni,5,9,214,179,94,12233,273,
kenett,5,9,20,373,445,11882,818,
fe,5,9,26,367,0,12327,367,
rw,5,10,320,73,274,12053,347,
goni,5,10,234,159,111,12216,270,
kenett,5,10,22,371,443,11884,814,
fe,5,10,29,364,0,12327,364,
rw,5,11,330,63,299,12028,362,
goni,5,11,246,147,124,12203,271,
kenett,5,11,31,362,440,11887,802,
fe,5,11,32,361,0,12327,361,
rw,5,12,341,52,326,12001,378,
goni,5,12,260,133,136,12191,269,
kenett,5,12,31,362,440,11887,802,
fe,5,12,35,358,0,12327,358,
rw,5,13,348,45,347,11980,392,
goni,5,13,274,119,148,12179,267,
kenett,5,13,28,365,443,11884,808,
fe,5,13,37,356,0,12327,356,
rw,5,14,354,39,373,11954,412,
goni,5,14,284,109,160,12167,269,
kenett,5,14,29,364,442,11885,806,
fe,5,14,40,353,0,12327,353,
rw,5,15,356,37,405,11922,442,
goni,5,15,294,99,170,12157,269,
kenett,5,15,33,360,438,11889,798,
fe,5,15,43,350,0,12327,350,
rw,5,16,361,32,425,11902,457,
goni,5,16,297,96,183,12144,279,
kenett,5,16,33,360,438,11889,798,
fe,5,16,46,347,0,12327,347,
rw,5,17,365,28,448,11879,476,
goni,5,17,307,86,190,12137,276,
kenett,5,17,30,363,441,11886,804,
fe,5,17,49,344,0,12327,344,
rw,5,18,369,24,472,11855,496,
goni,5,18,313,80,190,12137,270,
kenett,5,18,36,357,435,11892,792,
fe,5,18,52,341,0,12327,341,
rw,5,19,372,21,496,11831,517,
goni,5,19,322,71,193,12134,264,
kenett,5,19,228,165,246,12081,411,
fe,5,19,54,339,0,12327,339,
rw,5,20,374,19,517,11810,536,
goni,5,20,327,66,198,12129,264,
kenett,5,20,232,161,242,12085,403,
fe,5,20,56,337,0,12327,337,
rw,5,21,375,18,543,11784,561,
goni,5,21,333,60,210,12117,270,
kenett,5,21,236,157,238,12089,395,
fe,5,21,58,335,0,12327,335,
rw,5,22,376,17,566,11761,583,
goni,5,22,337,56,218,12109,274,
kenett,5,22,240,153,234,12093,387,
fe,5,22,61,332,0,12327,332,
rw,5,23,380,13,589,11738,602,
goni,5,23,337,56,222,12105,278,
kenett,5,23,237,156,237,12090,393,
fe,5,23,64,329,0,12327,329,
rw,5,24,383,10,614,11713,624,
goni,5,24,347,46,234,12093,280,
kenett,5,24,234,159,240,12087,399,
fe,5,24,66,327,0,12327,327,
rw,5,25,383,10,636,11691,646,
goni,5,25,345,48,248,12079,296,
kenett,5,25,240,153,234,12093,387,
fe,5,25,67,326,0,12327,326,
rw,5,26,385,8,651,11676,659,
goni,5,26,348,45,252,12075,297,
kenett,5,26,246,147,228,12099,375,
fe,5,26,70,323,0,12327,323,
rw,5,27,386,7,680,11647,687,
goni,5,27,352,41,257,12070,298,
kenett,5,27,250,143,224,12103,367,
fe,5,27,73,320,0,12327,320,
rw,5,28,386,7,702,11625,709,
goni,5,28,358,35,269,12058,304,
kenett,5,28,249,144,225,12102,369,
fe,5,28,76,317,0,12327,317,
rw,5,29,387,6,722,11605,728,
goni,5,29,359,34,280,12047,314,
kenett,5,29,248,145,226,12101,371,
fe,5,29,79,314,0,12327,314,
rw,5,30,387,6,745,11582,751,
goni,5,30,361,32,296,12031,328,
kenett,5,30,259,134,215,12112,349,
fe,5,30,81,312,0,12327,312,
rw,5,31,387,6,765,11562,771,
goni,5,31,363,30,310,12017,340,
kenett,5,31,265,128,209,12118,337,
fe,5,31,83,310,0,12327,310,
rw,5,32,388,5,785,11542,790,
goni,5,32,367,26,318,12009,344,
kenett,5,32,259,134,215,12112,349,
fe,5,32,86,307,0,12327,307,
rw,5,33,389,4,801,11526,805,
goni,5,33,368,25,320,12007,345,
kenett,5,33,259,134,215,12112,349,
fe,5,33,89,304,0,12327,304,
rw,5,34,389,4,817,11510,821,
goni,5,34,370,23,322,12005,345,
kenett,5,34,265,128,209,12118,337,
fe,5,34,92,301,0,12327,301,
rw,5,35,391,2,839,11488,841,
goni,5,35,368,25,330,11997,355,
kenett,5,35,258,135,216,12111,351,
fe,5,35,93,300,0,12327,300,
rw,5,36,392,1,858,11469,859,
goni,5,36,367,26,334,11993,360,
kenett,5,36,260,133,214,12113,347,
fe,5,36,95,298,0,12327,298,
rw,5,37,393,0,874,11453,874,
goni,5,37,364,29,347,11980,376,
kenett,5,37,264,129,210,12117,339,
fe,5,37,95,298,0,12327,298,
rw,5,38,393,0,901,11426,901,
goni,5,38,363,30,355,11972,385,
kenett,5,38,264,129,210,12117,339,
fe,5,38,95,298,0,12327,298,
rw,5,39,393,0,925,11402,925,
goni,5,39,364,29,357,11970,386,
kenett,5,39,272,121,202,12125,323,
fe,5,39,97,296,0,12327,296,
rw,5,40,393,0,944,11383,944,
goni,5,40,368,25,360,11967,385,
kenett,5,40,270,123,204,12123,327,
fe,5,40,99,294,0,12327,294,
rw,5,41,393,0,964,11363,964,
goni,5,41,369,24,374,11953,398,
kenett,5,41,265,128,209,12118,337,
fe,5,41,101,292,0,12327,292,
rw,5,42,393,0,982,11345,982,
goni,5,42,373,20,381,11946,401,
kenett,5,42,267,126,207,12120,333,
fe,5,42,101,292,0,12327,292,
rw,5,43,393,0,1002,11325,1002,
goni,5,43,377,16,387,11940,403,
kenett,5,43,265,128,209,12118,337,
fe,5,43,102,291,0,12327,291,
rw,5,44,393,0,1017,11310,1017,
goni,5,44,376,17,390,11937,407,
kenett,5,44,275,118,199,12128,317,
fe,5,44,105,288,0,12327,288,
rw,5,45,393,0,1040,11287,1040,
goni,5,45,376,17,398,11929,415,
kenett,5,45,268,125,206,12121,331,
fe,5,45,107,286,0,12327,286,
rw,5,46,393,0,1059,11268,1059,
goni,5,46,377,16,403,11924,419,
kenett,5,46,265,128,209,12118,337,
fe,5,46,110,283,0,12327,283,
rw,5,47,393,0,1076,11251,1076,
goni,5,47,380,13,409,11918,422,
kenett,5,47,267,126,207,12120,333,
fe,5,47,113,280,0,12327,280,
rw,5,48,393,0,1088,11239,1088,
goni,5,48,377,16,418,11909,434,
kenett,5,48,267,126,207,12120,333,
fe,5,48,116,277,0,12327,277,
rw,5,49,393,0,1106,11221,1106,
goni,5,49,378,15,419,11908,434,
kenett,5,49,260,133,214,12113,347,
fe,5,49,119,274,0,12327,274,
rw,5,50,393,0,1130,11197,1130,
goni,5,50,379,14,423,11904,437,
kenett,5,50,260,133,214,12113,347,
fe,5,50,121,272,0,12327,272,
rw,6,1,65,328,31,12296,359,
goni,6,1,8,385,0,12327,385,
kenett,6,1,10,383,230,12097,613,
fe,6,1,3,390,0,12327,390,
rw,6,2,122,271,64,12263,335,
goni,6,2,24,369,3,12324,372,
kenett,6,2,17,376,349,11978,725,
fe,6,2,6,387,0,12327,387,
rw,6,3,162,231,98,12229,329,
goni,6,3,52,341,12,12315,353,
kenett,6,3,15,378,411,11916,789,
fe,6,3,9,384,0,12327,384,
rw,6,4,197,196,134,12193,330,
goni,6,4,83,310,26,12301,336,
kenett,6,4,20,373,424,11903,797,
fe,6,4,12,381,0,12327,381,
rw,6,5,230,163,163,12164,326,
goni,6,5,114,279,36,12291,315,
kenett,6,5,16,377,437,11890,814,
fe,6,5,15,378,0,12327,378,
rw,6,6,254,139,196,12131,335,
goni,6,6,148,245,46,12281,291,
kenett,6,6,17,376,445,11882,821,
fe,6,6,18,375,0,12327,375,
rw,6,7,270,123,223,12104,346,
goni,6,7,172,221,66,12261,287,
kenett,6,7,13,380,455,11872,835,
fe,6,7,21,372,0,12327,372,
rw,6,8,287,106,256,12071,362,
goni,6,8,190,203,79,12248,282,
kenett,6,8,22,371,449,11878,820,
fe,6,8,24,369,0,12327,369,
rw,6,9,308,85,281,12046,366,
goni,6,9,211,182,98,12229,280,
kenett,6,9,18,375,453,11874,828,
fe,6,9,27,366,0,12327,366,
rw,6,10,316,77,301,12026,378,
goni,6,10,237,156,103,12224,259,
kenett,6,10,186,207,288,12039,495,
fe,6,10,30,363,0,12327,363,
rw,6,11,329,64,323,12004,387,
goni,6,11,246,147,114,12213,261,
kenett,6,11,192,201,282,12045,483,
fe,6,11,32,361,0,12327,361,
rw,6,12,340,53,350,11977,403,
goni,6,12,260,133,123,12204,256,
kenett,6,12,207,186,267,12060,453,
fe,6,12,35,358,0,12327,358,
rw,6,13,350,43,373,11954,416,
goni,6,13,268,125,126,12201,251,
kenett,6,13,193,200,281,12046,481,
fe,6,13,38,355,0,12327,355,
rw,6,14,352,41,395,11932,436,
goni,6,14,278,115,149,12178,264,
kenett,6,14,202,191,272,12055,463,
fe,6,14,41,352,0,12327,352,
rw,6,15,356,37,433,11894,470,
goni,6,15,286,107,152,12175,259,
kenett,6,15,207,186,267,12060,453,
fe,6,15,44,349,0,12327,349,
rw,6,16,362,31,459,11868,490,
goni,6,16,297,96,167,12160,263,
kenett,6,16,207,186,267,12060,453,
fe,6,16,47,346,0,12327,346,
rw,6,17,365,28,486,11841,514,
goni,6,17,303,90,182,12145,272,
kenett,6,17,215,178,259,12068,437,
fe,6,17,50,343,0,12327,343,
rw,6,18,369,24,513,11814,537,
goni,6,18,307,86,186,12141,272,
kenett,6,18,218,175,256,12071,431,
fe,6,18,53,340,0,12327,340,
rw,6,19,374,19,538,11789,557,
goni,6,19,317,76,200,12127,276,
kenett,6,19,220,173,254,12073,427,
fe,6,19,54,339,0,12327,339,
rw,6,20,378,15,554,11773,569,
goni,6,20,329,64,205,12122,269,
kenett,6,20,222,171,252,12075,423,
fe,6,20,55,338,0,12327,338,
rw,6,21,379,14,573,11754,587,
goni,6,21,335,58,216,12111,274,
kenett,6,21,228,165,246,12081,411,
fe,6,21,56,337,0,12327,337,
rw,6,22,380,13,592,11735,605,
goni,6,22,342,51,223,12104,274,
kenett,6,22,233,160,241,12086,401,
fe,6,22,59,334,0,12327,334,
rw,6,23,383,10,611,11716,621,
goni,6,23,344,49,226,12101,275,
kenett,6,23,233,160,241,12086,401,
fe,6,23,62,331,0,12327,331,
rw,6,24,385,8,627,11700,635,
goni,6,24,345,48,237,12090,285,
kenett,6,24,237,156,237,12090,393,
fe,6,24,65,328,0,12327,328,
rw,6,25,386,7,649,11678,656,
goni,6,25,348,45,241,12086,286,
kenett,6,25,242,151,232,12095,383,
fe,6,25,67,326,0,12327,326,
rw,6,26,386,7,669,11658,676,
goni,6,26,351,42,250,12077,292,
kenett,6,26,242,151,232,12095,383,
fe,6,26,69,324,0,12327,324,
rw,6,27,387,6,694,11633,700,
goni,6,27,353,40,251,12076,291,
kenett,6,27,244,149,230,12097,379,
fe,6,27,70,323,0,12327,323,
rw,6,28,388,5,718,11609,723,
goni,6,28,358,35,259,12068,294,
kenett,6,28,247,146,227,12100,373,
fe,6,28,73,320,0,12327,320,
rw,6,29,390,3,735,11592,738,
goni,6,29,359,34,268,12059,302,
kenett,6,29,254,139,220,12107,359,
fe,6,29,76,317,0,12327,317,
rw,6,30,391,2,760,11567,762,
goni,6,30,359,34,281,12046,315,
kenett,6,30,256,137,218,12109,355,
fe,6,30,77,316,0,12327,316,
rw,6,31,391,2,778,11549,780,
goni,6,31,361,32,281,12046,313,
kenett,6,31,259,134,215,12112,349,
fe,6,31,79,314,0,12327,314,
rw,6,32,391,2,798,11529,800,
goni,6,32,363,30,287,12040,317,
kenett,6,32,253,140,221,12106,361,
fe,6,32,80,313,0,12327,313,
rw,6,33,391,2,816,11511,818,
goni,6,33,367,26,298,12029,324,
kenett,6,33,254,139,220,12107,359,
fe,6,33,83,310,0,12327,310,
rw,6,34,391,2,829,11498,831,
goni,6,34,366,27,312,12015,339,
kenett,6,34,260,133,214,12113,347,
fe,6,34,84,309,0,12327,309,
rw,6,35,391,2,840,11487,842,
goni,6,35,369,24,317,12010,341,
kenett,6,35,255,138,219,12108,357,
fe,6,35,87,306,0,12327,306,
rw,6,36,391,2,855,11472,857,
goni,6,36,373,20,329,11998,349,
kenett,6,36,268,125,206,12121,331,
fe,6,36,89,304,0,12327,304,
rw,6,37,391,2,873,11454,875,
goni,6,37,372,21,329,11998,350,
kenett,6,37,262,131,212,12115,343,
fe,6,37,92,301,0,12327,301,
rw,6,38,391,2,896,11431,898,
goni,6,38,371,22,334,11993,356,
kenett,6,38,264,129,210,12117,339,
fe,6,38,94,299,0,12327,299,
rw,6,39,392,1,918,11409,919,
goni,6,39,373,20,344,11983,364,
kenett,6,39,258,135,216,12111,351,
fe,6,39,97,296,0,12327,296,
rw,6,40,392,1,934,11393,935,
goni,6,40,377,16,360,11967,376,
kenett,6,40,257,136,217,12110,353,
fe,6,40,99,294,0,12327,294,
rw,6,41,392,1,951,11376,952,
goni,6,41,380,13,358,11969,371,
kenett,6,41,257,136,217,12110,353,
fe,6,41,102,291,0,12327,291,
rw,6,42,392,1,967,11360,968,
goni,6,42,381,12,372,11955,384,
kenett,6,42,262,131,212,12115,343,
fe,6,42,105,288,0,12327,288,
rw,6,43,392,1,978,11349,979,
goni,6,43,382,11,377,11950,388,
kenett,6,43,266,127,208,12119,335,
fe,6,43,107,286,0,12327,286,
rw,6,44,392,1,994,11333,995,
goni,6,44,383,10,384,11943,394,
kenett,6,44,259,134,215,12112,349,
fe,6,44,109,284,0,12327,284,
rw,6,45,392,1,1008,11319,1009,
goni,6,45,383,10,388,11939,398,
kenett,6,45,267,126,207,12120,333,
fe,6,45,111,282,0,12327,282,
rw,6,46,392,1,1031,11296,1032,
goni,6,46,384,9,395,11932,404,
kenett,6,46,271,122,203,12124,325,
fe,6,46,113,280,0,12327,280,
rw,6,47,392,1,1048,11279,1049,
goni,6,47,384,9,398,11929,407,
kenett,6,47,268,125,206,12121,331,
fe,6,47,115,278,0,12327,278,
rw,6,48,393,0,1067,11260,1067,
goni,6,48,384,9,402,11925,411,
kenett,6,48,271,122,203,12124,325,
fe,6,48,118,275,0,12327,275,
rw,6,49,393,0,1088,11239,1088,
goni,6,49,386,7,409,11918,416,
kenett,6,49,272,121,202,12125,323,
fe,6,49,120,273,0,12327,273,
rw,6,50,393,0,1105,11222,1105,
goni,6,50,386,7,412,11915,419,
kenett,6,50,273,120,201,12126,321,
fe,6,50,123,270,0,12327,270,
rw,7,1,67,326,31,12296,357,
goni,7,1,7,386,1,12326,387,
kenett,7,1,10,383,218,12109,601,
fe,7,1,3,390,0,12327,390,
rw,7,2,120,273,57,12270,330,
goni,7,2,34,359,6,12321,365,
kenett,7,2,20,373,298,12029,671,
fe,7,2,6,387,0,12327,387,
rw,7,3,170,223,92,12235,315,
goni,7,3,60,333,15,12312,348,
kenett,7,3,14,379,403,11924,782,
fe,7,3,9,384,0,12327,384,
rw,7,4,203,190,125,12202,315,
goni,7,4,83,310,24,12303,334,
kenett,7,4,13,380,425,11902,805,
fe,7,4,12,381,0,12327,381,
rw,7,5,240,153,158,12169,311,
goni,7,5,107,286,30,12297,316,
kenett,7,5,14,379,439,11888,818,
fe,7,5,15,378,0,12327,378,
rw,7,6,262,131,192,12135,323,
goni,7,6,123,270,53,12274,323,
kenett,7,6,15,378,444,11883,822,
fe,7,6,18,375,0,12327,375,
rw,7,7,278,115,221,12106,336,
goni,7,7,152,241,66,12261,307,
kenett,7,7,17,376,445,11882,821,
fe,7,7,21,372,0,12327,372,
rw,7,8,296,97,248,12079,345,
goni,7,8,172,221,78,12249,299,
kenett,7,8,15,378,453,11874,831,
fe,7,8,24,369,0,12327,369,
rw,7,9,314,79,274,12053,353,
goni,7,9,191,202,85,12242,287,
kenett,7,9,19,374,449,11878,823,
fe,7,9,25,368,0,12327,368,
rw,7,10,324,69,304,12023,373,
goni,7,10,209,184,94,12233,278,
kenett,7,10,18,375,450,11877,825,
fe,7,10,28,365,0,12327,365,
rw,7,11,335,58,336,11991,394,
goni,7,11,231,162,103,12224,265,
kenett,7,11,32,361,439,11888,800,
fe,7,11,31,362,0,12327,362,
rw,7,12,342,51,360,11967,411,
goni,7,12,247,146,113,12214,259,
kenett,7,12,177,216,297,12030,513,
fe,7,12,33,360,0,12327,360,
rw,7,13,348,45,385,11942,430,
goni,7,13,254,139,124,12203,263,
kenett,7,13,191,202,283,12044,485,
fe,7,13,35,358,0,12327,358,
rw,7,14,358,35,417,11910,452,
goni,7,14,275,118,143,12184,261,
kenett,7,14,193,200,281,12046,481,
fe,7,14,38,355,0,12327,355,
rw,7,15,364,29,448,11879,477,
goni,7,15,279,114,145,12182,259,
kenett,7,15,213,180,261,12066,441,
fe,7,15,41,352,0,12327,352,
rw,7,16,370,23,475,11852,498,
goni,7,16,283,110,154,12173,264,
kenett,7,16,227,166,247,12080,413,
fe,7,16,44,349,0,12327,349,
rw,7,17,376,17,497,11830,514,
goni,7,17,291,102,161,12166,263,
kenett,7,17,213,180,261,12066,441,
fe,7,17,47,346,0,12327,346,
rw,7,18,377,16,524,11803,540,
goni,7,18,301,92,163,12164,255,
kenett,7,18,212,181,262,12065,443,
fe,7,18,50,343,0,12327,343,
rw,7,19,378,15,548,11779,563,
goni,7,19,309,84,174,12153,258,
kenett,7,19,225,168,249,12078,417,
fe,7,19,51,342,0,12327,342,
rw,7,20,381,12,569,11758,581,
goni,7,20,319,74,178,12149,252,
kenett,7,20,230,163,244,12083,407,
fe,7,20,54,339,0,12327,339,
rw,7,21,383,10,586,11741,596,
goni,7,21,327,66,199,12128,265,
kenett,7,21,234,159,240,12087,399,
fe,7,21,56,337,0,12327,337,
rw,7,22,383,10,614,11713,624,
goni,7,22,329,64,203,12124,267,
kenett,7,22,234,159,240,12087,399,
fe,7,22,59,334,0,12327,334,
rw,7,23,385,8,638,11689,646,
goni,7,23,331,62,215,12112,277,
kenett,7,23,234,159,240,12087,399,
fe,7,23,62,331,0,12327,331,
rw,7,24,386,7,668,11659,675,
goni,7,24,330,63,228,12099,291,
kenett,7,24,247,146,227,12100,373,
fe,7,24,64,329,0,12327,329,
rw,7,25,387,6,695,11632,701,
goni,7,25,333,60,232,12095,292,
kenett,7,25,242,151,232,12095,383,
fe,7,25,67,326,0,12327,326,
rw,7,26,388,5,709,11618,714,
goni,7,26,344,49,232,12095,281,
kenett,7,26,239,154,235,12092,389,
fe,7,26,69,324,0,12327,324,
rw,7,27,389,4,729,11598,733,
goni,7,27,345,48,240,12087,288,
kenett,7,27,237,156,237,12090,393,
fe,7,27,71,322,0,12327,322,
rw,7,28,391,2,751,11576,753,
goni,7,28,349,44,249,12078,293,
kenett,7,28,241,152,233,12094,385,
fe,7,28,74,319,0,12327,319,
rw,7,29,391,2,775,11552,777,
goni,7,29,357,36,260,12067,296,
kenett,7,29,243,150,231,12096,381,
fe,7,29,75,318,0,12327,318,
rw,7,30,391,2,788,11539,790,
goni,7,30,358,35,276,12051,311,
kenett,7,30,255,138,219,12108,357,
fe,7,30,77,316,0,12327,316,
rw,7,31,391,2,809,11518,811,
goni,7,31,359,34,277,12050,311,
kenett,7,31,251,142,223,12104,365,
fe,7,31,79,314,0,12327,314,
rw,7,32,391,2,831,11496,833,
goni,7,32,360,33,287,12040,320,
kenett,7,32,256,137,218,12109,355,
fe,7,32,81,312,0,12327,312,
rw,7,33,391,2,858,11469,860,
goni,7,33,361,32,295,12032,327,
kenett,7,33,259,134,215,12112,349,
fe,7,33,83,310,0,12327,310,
rw,7,34,391,2,877,11450,879,
goni,7,34,363,30,287,12040,317,
kenett,7,34,258,135,216,12111,351,
fe,7,34,85,308,0,12327,308,
rw,7,35,391,2,889,11438,891,
goni,7,35,364,29,292,12035,321,
kenett,7,35,258,135,216,12111,351,
fe,7,35,87,306,0,12327,306,
rw,7,36,392,1,913,11414,914,
goni,7,36,366,27,301,12026,328,
kenett,7,36,254,139,220,12107,359,
fe,7,36,90,303,0,12327,303,
rw,7,37,392,1,938,11389,939,
goni,7,37,369,24,305,12022,329,
kenett,7,37,255,138,219,12108,357,
fe,7,37,93,300,0,12327,300,
rw,7,38,392,1,955,11372,956,
goni,7,38,370,23,314,12013,337,
kenett,7,38,261,132,213,12114,345,
fe,7,38,95,298,0,12327,298,
rw,7,39,392,1,978,11349,979,
goni,7,39,370,23,325,12002,348,
kenett,7,39,263,130,211,12116,341,
fe,7,39,98,295,0,12327,295,
rw,7,40,392,1,991,11336,992,
goni,7,40,370,23,341,11986,364,
kenett,7,40,260,133,214,12113,347,
fe,7,40,101,292,0,12327,292,
rw,7,41,392,1,1008,11319,1009,
goni,7,41,373,20,350,11977,370,
kenett,7,41,266,127,208,12119,335,
fe,7,41,103,290,0,12327,290,
rw,7,42,392,1,1025,11302,1026,
goni,7,42,372,21,357,11970,378,
kenett,7,42,265,128,209,12118,337,
fe,7,42,105,288,0,12327,288,
rw,7,43,393,0,1043,11284,1043,
goni,7,43,374,19,361,11966,380,
kenett,7,43,269,124,205,12122,329,
fe,7,43,107,286,0,12327,286,
rw,7,44,393,0,1060,11267,1060,
goni,7,44,373,20,381,11946,401,
kenett,7,44,270,123,204,12123,327,
fe,7,44,110,283,0,12327,283,
rw,7,45,393,0,1078,11249,1078,
goni,7,45,374,19,382,11945,401,
kenett,7,45,265,128,209,12118,337,
fe,7,45,112,281,0,12327,281,
rw,7,46,393,0,1095,11232,1095,
goni,7,46,375,18,388,11939,406,
kenett,7,46,265,128,209,12118,337,
fe,7,46,112,281,0,12327,281,
rw,7,47,393,0,1109,11218,1109,
goni,7,47,374,19,394,11933,413,
kenett,7,47,265,128,209,12118,337,
fe,7,47,113,280,0,12327,280,
rw,7,48,393,0,1118,11209,1118,
goni,7,48,376,17,399,11928,416,
kenett,7,48,262,131,212,12115,343,
fe,7,48,115,278,0,12327,278,
rw,7,49,393,0,1130,11197,1130,
goni,7,49,376,17,409,11918,426,
kenett,7,49,265,128,209,12118,337,
fe,7,49,118,275,0,12327,275,
rw,7,50,393,0,1144,11183,1144,
goni,7,50,378,15,419,11908,434,
kenett,7,50,269,124,205,12122,329,
fe,7,50,121,272,0,12327,272,
rw,8,1,68,325,31,12296,356,
goni,8,1,5,388,3,12324,391,
kenett,8,1,8,385,244,12083,629,
fe,8,1,3,390,0,12327,390,
rw,8,2,122,271,62,12265,333,
goni,8,2,26,367,9,12318,376,
kenett,8,2,17,376,361,11966,737,
fe,8,2,6,387,0,12327,387,
rw,8,3,166,227,96,12231,323,
goni,8,3,51,342,20,12307,362,
kenett,8,3,18,375,411,11916,786,
fe,8,3,9,384,0,12327,384,
rw,8,4,198,195,126,12201,321,
goni,8,4,88,305,31,12296,336,
kenett,8,4,12,381,426,11901,807,
fe,8,4,12,381,0,12327,381,
rw,8,5,223,170,150,12177,320,
goni,8,5,129,264,47,12280,311,
kenett,8,5,16,377,431,11896,808,
fe,8,5,15,378,0,12327,378,
rw,8,6,254,139,173,12154,312,
goni,8,6,149,244,57,12270,301,
kenett,8,6,21,372,432,11895,804,
fe,8,6,18,375,0,12327,375,
rw,8,7,274,119,200,12127,319,
goni,8,7,169,224,63,12264,287,
kenett,8,7,14,379,445,11882,824,
fe,8,7,21,372,0,12327,372,
rw,8,8,298,95,233,12094,328,
goni,8,8,199,194,81,12246,275,
kenett,8,8,36,357,435,11892,792,
fe,8,8,24,369,0,12327,369,
rw,8,9,310,83,262,12065,345,
goni,8,9,221,172,97,12230,269,
kenett,8,9,150,243,324,12003,567,
fe,8,9,27,366,0,12327,366,
rw,8,10,325,68,287,12040,355,
goni,8,10,230,163,105,12222,268,
kenett,8,10,157,236,317,12010,553,
fe,8,10,30,363,0,12327,363,
rw,8,11,335,58,317,12010,375,
goni,8,11,246,147,115,12212,262,
kenett,8,11,160,233,314,12013,547,
fe,8,11,33,360,0,12327,360,
rw,8,12,344,49,350,11977,399,
goni,8,12,262,131,126,12201,257,
kenett,8,12,171,222,303,12024,525,
fe,8,12,36,357,0,12327,357,
rw,8,13,349,44,380,11947,424,
goni,8,13,270,123,144,12183,267,
kenett,8,13,181,212,293,12034,505,
fe,8,13,38,355,0,12327,355,
rw,8,14,353,40,409,11918,449,
goni,8,14,289,104,159,12168,263,
kenett,8,14,192,201,282,12045,483,
fe,8,14,40,353,0,12327,353,
rw,8,15,359,34,430,11897,464,
goni,8,15,299,94,162,12165,256,
kenett,8,15,191,202,283,12044,485,
fe,8,15,42,351,0,12327,351,
rw,8,16,365,28,453,11874,481,
goni,8,16,308,85,182,12145,267,
kenett,8,16,208,185,266,12061,451,
fe,8,16,44,349,0,12327,349,
rw,8,17,371,22,478,11849,500,
goni,8,17,315,78,188,12139,266,
kenett,8,17,206,187,268,12059,455,
fe,8,17,47,346,0,12327,346,
rw,8,18,377,16,500,11827,516,
goni,8,18,321,72,194,12133,266,
kenett,8,18,214,179,260,12067,439,
fe,8,18,50,343,0,12327,343,
rw,8,19,377,16,522,11805,538,
goni,8,19,327,66,204,12123,270,
kenett,8,19,221,172,253,12074,425,
fe,8,19,53,340,0,12327,340,
rw,8,20,379,14,541,11786,555,
goni,8,20,331,62,220,12107,282,
kenett,8,20,218,175,256,12071,431,
fe,8,20,56,337,0,12327,337,
rw,8,21,380,13,566,11761,579,
goni,8,21,333,60,221,12106,281,
kenett,8,21,230,163,244,12083,407,
fe,8,21,59,334,0,12327,334,
rw,8,22,380,13,587,11740,600,
goni,8,22,336,57,218,12109,275,
kenett,8,22,232,161,242,12085,403,
fe,8,22,62,331,0,12327,331,
rw,8,23,382,11,612,11715,623,
goni,8,23,340,53,228,12099,281,
kenett,8,23,236,157,238,12089,395,
fe,8,23,64,329,0,12327,329,
rw,8,24,384,9,630,11697,639,
goni,8,24,345,48,234,12093,282,
kenett,8,24,247,146,227,12100,373,
fe,8,24,67,326,0,12327,326,
rw,8,25,386,7,651,11676,658,
goni,8,25,343,50,244,12083,294,
kenett,8,25,242,151,232,12095,383,
fe,8,25,69,324,0,12327,324,
rw,8,26,389,4,672,11655,676,
goni,8,26,347,46,259,12068,305,
kenett,8,26,246,147,228,12099,375,
fe,8,26,71,322,0,12327,322,
rw,8,27,390,3,691,11636,694,
goni,8,27,351,42,263,12064,305,
kenett,8,27,251,142,223,12104,365,
fe,8,27,72,321,0,12327,321,
rw,8,28,391,2,713,11614,715,
goni,8,28,353,40,274,12053,314,
kenett,8,28,250,143,224,12103,367,
fe,8,28,75,318,0,12327,318,
rw,8,29,391,2,728,11599,730,
goni,8,29,359,34,277,12050,311,
kenett,8,29,254,139,220,12107,359,
fe,8,29,77,316,0,12327,316,
rw,8,30,391,2,749,11578,751,
goni,8,30,362,31,284,12043,315,
kenett,8,30,250,143,224,12103,367,
fe,8,30,80,313,0,12327,313,
rw,8,31,391,2,765,11562,767,
goni,8,31,365,28,286,12041,314,
kenett,8,31,258,135,216,12111,351,
fe,8,31,82,311,0,12327,311,
rw,8,32,391,2,783,11544,785,
goni,8,32,369,24,297,12030,321,
kenett,8,32,258,135,216,12111,351,
fe,8,32,85,308,0,12327,308,
rw,8,33,391,2,798,11529,800,
goni,8,33,372,21,305,12022,326,
kenett,8,33,258,135,216,12111,351,
fe,8,33,87,306,0,12327,306,
rw,8,34,391,2,816,11511,818,
goni,8,34,372,21,314,12013,335,
kenett,8,34,261,132,213,12114,345,
fe,8,34,90,303,0,12327,303,
rw,8,35,392,1,832,11495,833,
goni,8,35,372,21,315,12012,336,
kenett,8,35,264,129,210,12117,339,
fe,8,35,93,300,0,12327,300,
rw,8,36,392,1,850,11477,851,
goni,8,36,373,20,321,12006,341,
kenett,8,36,264,129,210,12117,339,
fe,8,36,95,298,0,12327,298,
rw,8,37,392,1,867,11460,868,
goni,8,37,373,20,337,11990,357,
kenett,8,37,268,125,206,12121,331,
fe,8,37,96,297,0,12327,297,
rw,8,38,392,1,888,11439,889,
goni,8,38,375,18,343,11984,361,
kenett,8,38,262,131,212,12115,343,
fe,8,38,98,295,0,12327,295,
rw,8,39,392,1,906,11421,907,
goni,8,39,379,14,346,11981,360,
kenett,8,39,267,126,207,12120,333,
fe,8,39,101,292,0,12327,292,
rw,8,40,392,1,923,11404,924,
goni,8,40,378,15,359,11968,374,
kenett,8,40,270,123,204,12123,327,
fe,8,40,103,290,0,12327,290,
rw,8,41,392,1,939,11388,940,
goni,8,41,380,13,362,11965,375,
kenett,8,41,266,127,208,12119,335,
fe,8,41,105,288,0,12327,288,
rw,8,42,392,1,956,11371,957,
goni,8,42,380,13,382,11945,395,
kenett,8,42,272,121,202,12125,323,
fe,8,42,106,287,0,12327,287,
rw,8,43,392,1,975,11352,976,
goni,8,43,380,13,383,11944,396,
kenett,8,43,268,125,206,12121,331,
fe,8,43,106,287,0,12327,287,
rw,8,44,392,1,984,11343,985,
goni,8,44,380,13,393,11934,406,
kenett,8,44,263,130,211,12116,341,
fe,8,44,109,284,0,12327,284,
rw,8,45,392,1,1002,11325,1003,
goni,8,45,379,14,398,11929,412,
kenett,8,45,263,130,211,12116,341,
fe,8,45,112,281,0,12327,281,
rw,8,46,392,1,1016,11311,1017,
goni,8,46,380,13,405,11922,418,
kenett,8,46,262,131,212,12115,343,
fe,8,46,114,279,0,12327,279,
rw,8,47,392,1,1035,11292,1036,
goni,8,47,380,13,408,11919,421,
kenett,8,47,262,131,212,12115,343,
fe,8,47,115,278,0,12327,278,
rw,8,48,392,1,1049,11278,1050,
goni,8,48,379,14,411,11916,425,
kenett,8,48,262,131,212,12115,343,
fe,8,48,117,276,0,12327,276,
rw,8,49,392,1,1064,11263,1065,
goni,8,49,380,13,408,11919,421,
kenett,8,49,263,130,211,12116,341,
fe,8,49,118,275,0,12327,275,
rw,8,50,392,1,1077,11250,1078,
goni,8,50,380,13,415,11912,428,
kenett,8,50,277,116,197,12130,313,
fe,8,50,120,273,0,12327,273,
rw,9,1,65,328,35,12292,363,
goni,9,1,4,389,3,12324,392,
kenett,9,1,14,379,196,12131,575,
fe,9,1,3,390,0,12327,390,
rw,9,2,124,269,62,12265,331,
goni,9,2,20,373,6,12321,379,
kenett,9,2,16,377,290,12037,667,
fe,9,2,6,387,0,12327,387,
rw,9,3,170,223,87,12240,310,
goni,9,3,60,333,16,12311,349,
kenett,9,3,15,378,357,11970,735,
fe,9,3,9,384,0,12327,384,
rw,9,4,201,192,117,12210,309,
goni,9,4,91,302,22,12305,324,
kenett,9,4,18,375,384,11943,759,
fe,9,4,11,382,0,12327,382,
rw,9,5,238,155,148,12179,303,
goni,9,5,120,273,31,12296,304,
kenett,9,5,17,376,412,11915,788,
fe,9,5,14,379,0,12327,379,
rw,9,6,253,140,186,12141,326,
goni,9,6,141,252,44,12283,296,
kenett,9,6,18,375,423,11904,798,
fe,9,6,17,376,0,12327,376,
rw,9,7,273,120,211,12116,331,
goni,9,7,164,229,53,12274,282,
kenett,9,7,14,379,430,11897,809,
fe,9,7,20,373,0,12327,373,
rw,9,8,291,102,239,12088,341,
goni,9,8,180,213,56,12271,269,
kenett,9,8,20,373,442,11885,815,
fe,9,8,23,370,0,12327,370,
rw,9,9,311,82,267,12060,349,
goni,9,9,210,183,71,12256,254,
kenett,9,9,27,366,438,11889,804,
fe,9,9,25,368,0,12327,368,
rw,9,10,316,77,286,12041,363,
goni,9,10,226,167,88,12239,255,
kenett,9,10,23,370,442,11885,812,
fe,9,10,28,365,0,12327,365,
rw,9,11,328,65,313,12014,378,
goni,9,11,248,145,99,12228,244,
kenett,9,11,39,354,432,11895,786,
fe,9,11,31,362,0,12327,362,
rw,9,12,336,57,342,11985,399,
goni,9,12,268,125,111,12216,236,
kenett,9,12,27,366,444,11883,810,
fe,9,12,34,359,0,12327,359,
rw,9,13,342,51,369,11958,420,
goni,9,13,269,124,126,12201,250,
kenett,9,13,35,358,436,11891,794,
fe,9,13,37,356,0,12327,356,
rw,9,14,349,44,398,11929,442,
goni,9,14,286,107,144,12183,251,
kenett,9,14,39,354,432,11895,786,
fe,9,14,40,353,0,12327,353,
rw,9,15,360,33,412,11915,445,
goni,9,15,293,100,150,12177,250,
kenett,9,15,39,354,432,11895,786,
fe,9,15,42,351,0,12327,351,
rw,9,16,362,31,433,11894,464,
goni,9,16,296,97,161,12166,258,
kenett,9,16,45,348,426,11901,774,
fe,9,16,45,348,0,12327,348,
rw,9,17,370,23,456,11871,479,
goni,9,17,300,93,164,12163,257,
kenett,9,17,220,173,254,12073,427,
fe,9,17,48,345,0,12327,345,
rw,9,18,374,19,475,11852,494,
goni,9,18,304,89,170,12157,259,
kenett,9,18,225,168,249,12078,417,
fe,9,18,51,342,0,12327,342,
rw,9,19,379,14,497,11830,511,
goni,9,19,320,73,181,12146,254,
kenett,9,19,232,161,242,12085,403,
fe,9,19,53,340,0,12327,340,
rw,9,20,381,12,519,11808,531,
goni,9,20,326,67,197,12130,264,
kenett,9,20,235,158,239,12088,397,
fe,9,20,56,337,0,12327,337,
rw,9,21,382,11,546,11781,557,
goni,9,21,334,59,207,12120,266,
kenett,9,21,235,158,239,12088,397,
fe,9,21,58,335,0,12327,335,
rw,9,22,385,8,570,11757,578,
goni,9,22,342,51,218,12109,269,
kenett,9,22,239,154,235,12092,389,
fe,9,22,61,332,0,12327,332,
rw,9,23,385,8,600,11727,608,
goni,9,23,341,52,224,12103,276,
kenett,9,23,251,142,223,12104,365,
fe,9,23,63,330,0,12327,330,
rw,9,24,385,8,624,11703,632,
goni,9,24,346,47,230,12097,277,
kenett,9,24,249,144,225,12102,369,
fe,9,24,66,327,0,12327,327,
rw,9,25,386,7,648,11679,655,
goni,9,25,347,46,246,12081,292,
kenett,9,25,252,141,222,12105,363,
fe,9,25,68,325,0,12327,325,
rw,9,26,387,6,668,11659,674,
goni,9,26,346,47,256,12071,303,
kenett,9,26,253,140,221,12106,361,
fe,9,26,70,323,0,12327,323,
rw,9,27,387,6,684,11643,690,
goni,9,27,351,42,266,12061,308,
kenett,9,27,253,140,221,12106,361,
fe,9,27,70,323,0,12327,323,
rw,9,28,388,5,700,11627,705,
goni,9,28,356,37,280,12047,317,
kenett,9,28,257,136,217,12110,353,
fe,9,28,73,320,0,12327,320,
rw,9,29,388,5,719,11608,724,
goni,9,29,358,35,286,12041,321,
kenett,9,29,254,139,220,12107,359,
fe,9,29,74,319,0,12327,319,
rw,9,30,388,5,738,11589,743,
goni,9,30,362,31,290,12037,321,
kenett,9,30,258,135,216,12111,351,
fe,9,30,74,319,0,12327,319,
rw,9,31,388,5,750,11577,755,
goni,9,31,364,29,292,12035,321,
kenett,9,31,256,137,218,12109,355,
fe,9,31,77,316,0,12327,316,
rw,9,32,389,4,777,11550,781,
goni,9,32,365,28,303,12024,331,
kenett,9,32,259,134,215,12112,349,
fe,9,32,79,314,0,12327,314,
rw,9,33,389,4,805,11522,809,
goni,9,33,366,27,314,12013,341,
kenett,9,33,251,142,223,12104,365,
fe,9,33,82,311,0,12327,311,
rw,9,34,390,3,816,11511,819,
goni,9,34,367,26,316,12011,342,
kenett,9,34,259,134,215,12112,349,
fe,9,34,84,309,0,12327,309,
rw,9,35,391,2,837,11490,839,
goni,9,35,371,22,321,12006,343,
kenett,9,35,261,132,213,12114,345,
fe,9,35,85,308,0,12327,308,
rw,9,36,391,2,854,11473,856,
goni,9,36,371,22,316,12011,338,
kenett,9,36,265,128,209,12118,337,
fe,9,36,86,307,0,12327,307,
rw,9,37,392,1,871,11456,872,
goni,9,37,373,20,331,11996,351,
kenett,9,37,265,128,209,12118,337,
fe,9,37,88,305,0,12327,305,
rw,9,38,392,1,888,11439,889,
goni,9,38,375,18,335,11992,353,
kenett,9,38,262,131,212,12115,343,
fe,9,38,91,302,0,12327,302,
rw,9,39,393,0,911,11416,911,
goni,9,39,377,16,347,11980,363,
kenett,9,39,263,130,211,12116,341,
fe,9,39,93,300,0,12327,300,
rw,9,40,393,0,932,11395,932,
goni,9,40,381,12,356,11971,368,
kenett,9,40,262,131,212,12115,343,
fe,9,40,95,298,0,12327,298,
rw,9,41,393,0,948,11379,948,
goni,9,41,380,13,353,11974,366,
kenett,9,41,258,135,216,12111,351,
fe,9,41,98,295,0,12327,295,
rw,9,42,393,0,967,11360,967,
goni,9,42,380,13,359,11968,372,
kenett,9,42,258,135,216,12111,351,
fe,9,42,99,294,0,12327,294,
rw,9,43,393,0,984,11343,984,
goni,9,43,379,14,373,11954,387,
kenett,9,43,254,139,220,12107,359,
fe,9,43,101,292,0,12327,292,
rw,9,44,393,0,1001,11326,1001,
goni,9,44,380,13,379,11948,392,
kenett,9,44,259,134,215,12112,349,
fe,9,44,104,289,0,12327,289,
rw,9,45,393,0,1016,11311,1016,
goni,9,45,380,13,378,11949,391,
kenett,9,45,258,135,216,12111,351,
fe,9,45,107,286,0,12327,286,
rw,9,46,393,0,1029,11298,1029,
goni,9,46,382,11,389,11938,400,
kenett,9,46,264,129,210,12117,339,
fe,9,46,108,285,0,12327,285,
rw,9,47,393,0,1049,11278,1049,
goni,9,47,383,10,393,11934,403,
kenett,9,47,263,130,211,12116,341,
fe,9,47,110,283,0,12327,283,
rw,9,48,393,0,1065,11262,1065,
goni,9,48,385,8,395,11932,403,
kenett,9,48,266,127,208,12119,335,
fe,9,48,111,282,0,12327,282,
rw,9,49,393,0,1081,11246,1081,
goni,9,49,384,9,395,11932,404,
kenett,9,49,268,125,206,12121,331,
fe,9,49,113,280,0,12327,280,
rw,9,50,393,0,1098,11229,1098,
goni,9,50,385,8,404,11923,412,
kenett,9,50,270,123,204,12123,327,
fe,9,50,115,278,0,12327,278,
rw,10,1,66,327,32,12295,359,
goni,10,1,7,386,2,12325,388,
kenett,10,1,20,373,205,12122,578,
fe,10,1,3,390,0,12327,390,
rw,10,2,120,273,61,12266,334,
goni,10,2,25,368,12,12315,380,
kenett,10,2,14,379,310,12017,689,
fe,10,2,6,387,0,12327,387,
rw,10,3,176,217,85,12242,302,
goni,10,3,47,346,19,12308,365,
kenett,10,3,18,375,375,11952,750,
fe,10,3,9,384,0,12327,384,
rw,10,4,212,181,108,12219,289,
goni,10,4,82,311,33,12294,344,
kenett,10,4,23,370,397,11930,767,
fe,10,4,12,381,0,12327,381,
rw,10,5,244,149,138,12189,287,
goni,10,5,115,278,42,12285,320,
kenett,10,5,19,374,416,11911,790,
fe,10,5,15,378,0,12327,378,
rw,10,6,276,117,168,12159,285,
goni,10,6,144,249,55,12272,304,
kenett,10,6,17,376,427,11900,803,
fe,10,6,17,376,0,12327,376,
rw,10,7,294,99,194,12133,293,
goni,10,7,175,218,69,12258,287,
kenett,10,7,21,372,438,11889,810,
fe,10,7,20,373,0,12327,373,
rw,10,8,311,82,223,12104,305,
goni,10,8,192,201,77,12250,278,
kenett,10,8,16,377,449,11878,826,
fe,10,8,23,370,0,12327,370,
rw,10,9,319,74,249,12078,323,
goni,10,9,207,186,80,12247,266,
kenett,10,9,20,373,445,11882,818,
fe,10,9,26,367,0,12327,367,
rw,10,10,332,61,268,12059,329,
goni,10,10,227,166,99,12228,265,
kenett,10,10,20,373,448,11879,821,
fe,10,10,29,364,0,12327,364,
rw,10,11,339,54,295,12032,349,
goni,10,11,238,155,100,12227,255,
kenett,10,11,20,373,448,11879,821,
fe,10,11,32,361,0,12327,361,
rw,10,12,351,42,319,12008,361,
goni,10,12,246,147,110,12217,257,
kenett,10,12,26,367,442,11885,809,
fe,10,12,35,358,0,12327,358,
rw,10,13,356,37,338,11989,375,
goni,10,13,263,130,118,12209,248,
kenett,10,13,27,366,441,11886,807,
fe,10,13,37,356,0,12327,356,
rw,10,14,358,35,362,11965,397,
goni,10,14,268,125,122,12205,247,
kenett,10,14,17,376,451,11876,827,
fe,10,14,39,354,0,12327,354,
rw,10,15,360,33,388,11939,421,
goni,10,15,284,109,121,12206,230,
kenett,10,15,24,369,444,11883,813,
fe,10,15,42,351,0,12327,351,
rw,10,16,366,27,410,11917,437,
goni,10,16,291,102,143,12184,245,
kenett,10,16,22,371,446,11881,817,
fe,10,16,45,348,0,12327,348,
rw,10,17,369,24,430,11897,454,
goni,10,17,303,90,153,12174,243,
kenett,10,17,17,376,451,11876,827,
fe,10,17,48,345,0,12327,345,
rw,10,18,372,21,456,11871,477,
goni,10,18,317,76,171,12156,247,
kenett,10,18,21,372,450,11877,822,
fe,10,18,49,344,0,12327,344,
rw,10,19,377,16,486,11841,502,
goni,10,19,324,69,183,12144,252,
kenett,10,19,253,140,221,12106,361,
fe,10,19,52,341,0,12327,341,
rw,10,20,377,16,509,11818,525,
goni,10,20,326,67,204,12123,271,
kenett,10,20,244,149,230,12097,379,
fe,10,20,55,338,0,12327,338,
rw,10,21,379,14,533,11794,547,
goni,10,21,331,62,227,12100,289,
kenett,10,21,247,146,227,12100,373,
fe,10,21,58,335,0,12327,335,
rw,10,22,383,10,552,11775,562,
goni,10,22,336,57,220,12107,277,
kenett,10,22,247,146,227,12100,373,
fe,10,22,60,333,0,12327,333,
rw,10,23,384,9,578,11749,587,
goni,10,23,337,56,233,12094,289,
kenett,10,23,261,132,213,12114,345,
fe,10,23,63,330,0,12327,330,
rw,10,24,387,6,596,11731,602,
goni,10,24,341,52,241,12086,293,
kenett,10,24,260,133,214,12113,347,
fe,10,24,66,327,0,12327,327,
rw,10,25,388,5,616,11711,621,
goni,10,25,348,45,251,12076,296,
kenett,10,25,260,133,214,12113,347,
fe,10,25,68,325,0,12327,325,
rw,10,26,389,4,640,11687,644,
goni,10,26,351,42,265,12062,307,
kenett,10,26,257,136,217,12110,353,
fe,10,26,69,324,0,12327,324,
rw,10,27,389,4,666,11661,670,
goni,10,27,354,39,275,12052,314,
kenett,10,27,262,131,212,12115,343,
fe,10,27,72,321,0,12327,321,
rw,10,28,390,3,688,11639,691,
goni,10,28,355,38,286,12041,324,
kenett,10,28,265,128,209,12118,337,
fe,10,28,73,320,0,12327,320,
rw,10,29,391,2,708,11619,710,
goni,10,29,356,37,286,12041,323,
kenett,10,29,262,131,212,12115,343,
fe,10,29,75,318,0,12327,318,
rw,10,30,391,2,734,11593,736,
goni,10,30,357,36,299,12028,335,
kenett,10,30,258,135,216,12111,351,
fe,10,30,78,315,0,12327,315,
rw,10,31,391,2,757,11570,759,
goni,10,31,358,35,302,12025,337,
kenett,10,31,260,133,214,12113,347,
fe,10,31,81,312,0,12327,312,
rw,10,32,391,2,775,11552,777,
goni,10,32,359,34,318,12009,352,
kenett,10,32,263,130,211,12116,341,
fe,10,32,81,312,0,12327,312,
rw,10,33,391,2,792,11535,794,
goni,10,33,361,32,325,12002,357,
kenett,10,33,266,127,208,12119,335,
fe,10,33,84,309,0,12327,309,
rw,10,34,391,2,811,11516,813,
goni,10,34,363,30,321,12006,351,
kenett,10,34,263,130,211,12116,341,
fe,10,34,87,306,0,12327,306,
rw,10,35,391,2,828,11499,830,
goni,10,35,366,27,325,12002,352,
kenett,10,35,274,119,200,12127,319,
fe,10,35,89,304,0,12327,304,
rw,10,36,391,2,844,11483,846,
goni,10,36,371,22,333,11994,355,
kenett,10,36,268,125,206,12121,331,
fe,10,36,90,303,0,12327,303,
rw,10,37,391,2,856,11471,858,
goni,10,37,371,22,343,11984,365,
kenett,10,37,268,125,206,12121,331,
fe,10,37,93,300,0,12327,300,
rw,10,38,391,2,876,11451,878,
goni,10,38,368,25,350,11977,375,
kenett,10,38,261,132,213,12114,345,
fe,10,38,95,298,0,12327,298,
rw,10,39,391,2,893,11434,895,
goni,10,39,372,21,355,11972,376,
kenett,10,39,270,123,204,12123,327,
fe,10,39,98,295,0,12327,295,
rw,10,40,391,2,918,11409,920,
goni,10,40,372,21,358,11969,379,
kenett,10,40,271,122,203,12124,325,
fe,10,40,101,292,0,12327,292,
rw,10,41,391,2,934,11393,936,
goni,10,41,373,20,371,11956,391,
kenett,10,41,272,121,202,12125,323,
fe,10,41,104,289,0,12327,289,
rw,10,42,391,2,944,11383,946,
goni,10,42,380,13,369,11958,382,
kenett,10,42,272,121,202,12125,323,
fe,10,42,106,287,0,12327,287,
rw,10,43,391,2,965,11362,967,
goni,10,43,381,12,378,11949,390,
kenett,10,43,266,127,208,12119,335,
fe,10,43,108,285,0,12327,285,
rw,10,44,391,2,989,11338,991,
goni,10,44,383,10,382,11945,392,
kenett,10,44,270,123,204,12123,327,
fe,10,44,110,283,0,12327,283,
rw,10,45,391,2,1004,11323,1006,
goni,10,45,382,11,388,11939,399,
kenett,10,45,270,123,204,12123,327,
fe,10,45,112,281,0,12327,281,
rw,10,46,391,2,1015,11312,1017,
goni,10,46,382,11,383,11944,394,
kenett,10,46,275,118,199,12128,317,
fe,10,46,113,280,0,12327,280,
rw,10,47,391,2,1034,11293,1036,
goni,10,47,382,11,391,11936,402,
kenett,10,47,275,118,199,12128,317,
fe,10,47,114,279,0,12327,279,
rw,10,48,391,2,1058,11269,1060,
goni,10,48,382,11,403,11924,414,
kenett,10,48,275,118,199,12128,317,
fe,10,48,115,278,0,12327,278,
rw,10,49,391,2,1070,11257,1072,
goni,10,49,381,12,407,11920,419,
kenett,10,49,275,118,199,12128,317,
fe,10,49,117,276,0,12327,276,
rw,10,50,391,2,1086,11241,1088,
goni,10,50,382,11,409,11918,420,
kenett,10,50,270,123,204,12123,327,
fe,10,50,119,274,0,12327,274,
rw,11,1,67,326,31,12296,357,
goni,11,1,5,388,2,12325,390,
kenett,11,1,9,384,231,12096,615,
fe,11,1,3,390,0,12327,390,
rw,11,2,123,270,59,12268,329,
goni,11,2,31,362,9,12318,371,
kenett,11,2,15,378,333,11994,711,
fe,11,2,6,387,0,12327,387,
rw,11,3,167,226,91,12236,317,
goni,11,3,67,326,19,12308,345,
kenett,11,3,15,378,384,11943,762,
fe,11,3,9,384,0,12327,384,
rw,11,4,201,192,127,12200,319,
goni,11,4,93,300,32,12295,332,
kenett,11,4,15,378,411,11916,789,
fe,11,4,12,381,0,12327,381,
rw,11,5,236,157,154,12173,311,
goni,11,5,126,267,45,12282,312,
kenett,11,5,15,378,438,11889,816,
fe,11,5,15,378,0,12327,378,
rw,11,6,266,127,179,12148,306,
goni,11,6,151,242,52,12275,294,
kenett,11,6,18,375,444,11883,819,
fe,11,6,18,375,0,12327,375,
rw,11,7,288,105,208,12119,313,
goni,11,7,173,220,62,12265,282,
kenett,11,7,21,372,441,11886,813,
fe,11,7,21,372,0,12327,372,
rw,11,8,300,93,242,12085,335,
goni,11,8,184,209,73,12254,282,
kenett,11,8,17,376,445,11882,821,
fe,11,8,24,369,0,12327,369,
rw,11,9,314,79,268,12059,347,
goni,11,9,202,191,85,12242,276,
kenett,11,9,17,376,445,11882,821,
fe,11,9,27,366,0,12327,366,
rw,11,10,329,64,298,12029,362,
goni,11,10,221,172,100,12227,272,
kenett,11,10,17,376,448,11879,824,
fe,11,10,29,364,0,12327,364,
rw,11,11,338,55,326,12001,381,
goni,11,11,235,158,108,12219,266,
kenett,11,11,21,372,444,11883,816,
fe,11,11,32,361,0,12327,361,
rw,11,12,350,43,351,11976,394,
goni,11,12,251,142,117,12210,259,
kenett,11,12,17,376,448,11879,824,
fe,11,12,35,358,0,12327,358,
rw,11,13,361,32,375,11952,407,
goni,11,13,265,128,121,12206,249,
kenett,11,13,23,370,448,11879,818,
fe,11,13,37,356,0,12327,356,
rw,11,14,372,21,397,11930,418,
goni,11,14,279,114,132,12195,246,
kenett,11,14,38,355,433,11894,788,
fe,11,14,40,353,0,12327,353,
rw,11,15,374,19,427,11900,446,
goni,11,15,284,109,154,12173,263,
kenett,11,15,27,366,444,11883,810,
fe,11,15,43,350,0,12327,350,
rw,11,16,381,12,448,11879,460,
goni,11,16,294,99,162,12165,261,
kenett,11,16,22,371,449,11878,820,
fe,11,16,46,347,0,12327,347,
rw,11,17,383,10,474,11853,484,
goni,11,17,304,89,172,12155,261,
kenett,11,17,226,167,248,12079,415,
fe,11,17,48,345,0,12327,345,
rw,11,18,385,8,500,11827,508,
goni,11,18,306,87,177,12150,264,
kenett,11,18,228,165,246,12081,411,
fe,11,18,50,343,0,12327,343,
rw,11,19,386,7,522,11805,529,
goni,11,19,314,79,187,12140,266,
kenett,11,19,232,161,242,12085,403,
fe,11,19,52,341,0,12327,341,
rw,11,20,386,7,544,11783,551,
goni,11,20,319,74,191,12136,265,
kenett,11,20,236,157,238,12089,395,
fe,11,20,55,338,0,12327,338,
rw,11,21,389,4,570,11757,574,
goni,11,21,325,68,204,12123,272,
kenett,11,21,240,153,234,12093,387,
fe,11,21,58,335,0,12327,335,
rw,11,22,389,4,593,11734,597,
goni,11,22,329,64,209,12118,273,
kenett,11,22,243,150,231,12096,381,
fe,11,22,61,332,0,12327,332,
rw,11,23,390,3,612,11715,615,
goni,11,23,334,59,223,12104,282,
kenett,11,23,240,153,234,12093,387,
fe,11,23,64,329,0,12327,329,
rw,11,24,390,3,631,11696,634,
goni,11,24,339,54,236,12091,290,
kenett,11,24,243,150,231,12096,381,
fe,11,24,66,327,0,12327,327,
rw,11,25,390,3,655,11672,658,
goni,11,25,341,52,239,12088,291,
kenett,11,25,246,147,228,12099,375,
fe,11,25,68,325,0,12327,325,
rw,11,26,390,3,669,11658,672,
goni,11,26,345,48,252,12075,300,
kenett,11,26,247,146,227,12100,373,
fe,11,26,71,322,0,12327,322,
rw,11,27,390,3,694,11633,697,
goni,11,27,346,47,255,12072,302,
kenett,11,27,242,151,232,12095,383,
fe,11,27,74,319,0,12327,319,
rw,11,28,391,2,716,11611,718,
goni,11,28,351,42,270,12057,312,
kenett,11,28,253,140,221,12106,361,
fe,11,28,76,317,0,12327,317,
rw,11,29,391,2,744,11583,746,
goni,11,29,355,38,272,12055,310,
kenett,11,29,253,140,221,12106,361,
fe,11,29,78,315,0,12327,315,
rw,11,30,391,2,770,11557,772,
goni,11,30,355,38,280,12047,318,
kenett,11,30,259,134,215,12112,349,
fe,11,30,80,313,0,12327,313,
rw,11,31,391,2,791,11536,793,
goni,11,31,355,38,293,12034,331,
kenett,11,31,258,135,216,12111,351,
fe,11,31,83,310,0,12327,310,
rw,11,32,391,2,815,11512,817,
goni,11,32,356,37,307,12020,344,
kenett,11,32,258,135,216,12111,351,
fe,11,32,86,307,0,12327,307,
rw,11,33,392,1,834,11493,835,
goni,11,33,360,33,316,12011,349,
kenett,11,33,263,130,211,12116,341,
fe,11,33,89,304,0,12327,304,
rw,11,34,392,1,852,11475,853,
goni,11,34,359,34,325,12002,359,
kenett,11,34,261,132,213,12114,345,
fe,11,34,91,302,0,12327,302,
rw,11,35,392,1,869,11458,870,
goni,11,35,364,29,323,12004,352,
kenett,11,35,261,132,213,12114,345,
fe,11,35,94,299,0,12327,299,
rw,11,36,392,1,884,11443,885,
goni,11,36,367,26,334,11993,360,
kenett,11,36,261,132,213,12114,345,
fe,11,36,95,298,0,12327,298,
rw,11,37,393,0,898,11429,898,
goni,11,37,367,26,335,11992,361,
kenett,11,37,270,123,204,12123,327,
fe,11,37,97,296,0,12327,296,
rw,11,38,393,0,908,11419,908,
goni,11,38,370,23,341,11986,364,
kenett,11,38,267,126,207,12120,333,
fe,11,38,98,295,0,12327,295,
rw,11,39,393,0,922,11405,922,
goni,11,39,373,20,355,11972,375,
kenett,11,39,267,126,207,12120,333,
fe,11,39,101,292,0,12327,292,
rw,11,40,393,0,938,11389,938,
goni,11,40,373,20,357,11970,377,
kenett,11,40,265,128,209,12118,337,
fe,11,40,103,290,0,12327,290,
rw,11,41,393,0,953,11374,953,
goni,11,41,373,20,364,11963,384,
kenett,11,41,268,125,206,12121,331,
fe,11,41,105,288,0,12327,288,
rw,11,42,393,0,969,11358,969,
goni,11,42,376,17,370,11957,387,
kenett,11,42,268,125,206,12121,331,
fe,11,42,107,286,0,12327,286,
rw,11,43,393,0,983,11344,983,
goni,11,43,378,15,376,11951,391,
kenett,11,43,271,122,203,12124,325,
fe,11,43,107,286,0,12327,286,
rw,11,44,393,0,1002,11325,1002,
goni,11,44,379,14,386,11941,400,
kenett,11,44,271,122,203,12124,325,
fe,11,44,110,283,0,12327,283,
rw,11,45,393,0,1016,11311,1016,
goni,11,45,378,15,394,11933,409,
kenett,11,45,270,123,204,12123,327,
fe,11,45,112,281,0,12327,281,
rw,11,46,393,0,1037,11290,1037,
goni,11,46,377,16,396,11931,412,
kenett,11,46,263,130,211,12116,341,
fe,11,46,114,279,0,12327,279,
rw,11,47,393,0,1056,11271,1056,
goni,11,47,380,13,407,11920,420,
kenett,11,47,263,130,211,12116,341,
fe,11,47,117,276,0,12327,276,
rw,11,48,393,0,1077,11250,1077,
goni,11,48,379,14,414,11913,428,
kenett,11,48,265,128,209,12118,337,
fe,11,48,117,276,0,12327,276,
rw,11,49,393,0,1092,11235,1092,
goni,11,49,379,14,417,11910,431,
kenett,11,49,255,138,219,12108,357,
fe,11,49,120,273,0,12327,273,
rw,11,50,393,0,1108,11219,1108,
goni,11,50,381,12,426,11901,438,
kenett,11,50,257,136,217,12110,353,
fe,11,50,122,271,0,12327,271,
rw,12,1,63,330,35,12292,365,
goni,12,1,10,383,3,12324,386,
kenett,12,1,11,382,187,12140,569,
fe,12,1,3,390,0,12327,390,
rw,12,2,117,276,63,12264,339,
goni,12,2,27,366,9,12318,375,
kenett,12,2,14,379,313,12014,692,
fe,12,2,6,387,0,12327,387,
rw,12,3,159,234,103,12224,337,
goni,12,3,52,341,18,12309,359,
kenett,12,3,18,375,360,11967,735,
fe,12,3,9,384,0,12327,384,
rw,12,4,193,200,132,12195,332,
goni,12,4,75,318,27,12300,345,
kenett,12,4,16,377,410,11917,787,
fe,12,4,12,381,0,12327,381,
rw,12,5,220,173,153,12174,326,
goni,12,5,113,280,36,12291,316,
kenett,12,5,19,374,413,11914,787,
fe,12,5,15,378,0,12327,378,
rw,12,6,247,146,182,12145,328,
goni,12,6,143,250,37,12290,287,
kenett,12,6,18,375,429,11898,804,
fe,12,6,18,375,0,12327,375,
rw,12,7,277,116,213,12114,329,
goni,12,7,161,232,52,12275,284,
kenett,12,7,18,375,441,11886,816,
fe,12,7,21,372,0,12327,372,
rw,12,8,298,95,242,12085,337,
goni,12,8,176,217,72,12255,289,
kenett,12,8,17,376,445,11882,821,
fe,12,8,24,369,0,12327,369,
rw,12,9,312,81,270,12057,351,
goni,12,9,201,192,84,12243,276,
kenett,12,9,20,373,442,11885,815,
fe,12,9,27,366,0,12327,366,
rw,12,10,322,71,296,12031,367,
goni,12,10,207,186,93,12234,279,
kenett,12,10,17,376,448,11879,824,
fe,12,10,30,363,0,12327,363,
rw,12,11,331,62,320,12007,382,
goni,12,11,227,166,99,12228,265,
kenett,12,11,17,376,448,11879,824,
fe,12,11,32,361,0,12327,361,
rw,12,12,347,46,339,11988,385,
goni,12,12,250,143,121,12206,264,
kenett,12,12,32,361,439,11888,800,
fe,12,12,35,358,0,12327,358,
rw,12,13,353,40,364,11963,404,
goni,12,13,269,124,129,12198,253,
kenett,12,13,27,366,444,11883,810,
fe,12,13,38,355,0,12327,355,
rw,12,14,361,32,380,11947,412,
goni,12,14,282,111,129,12198,240,
kenett,12,14,31,362,440,11887,802,
fe,12,14,41,352,0,12327,352,
rw,12,15,366,27,412,11915,439,
goni,12,15,283,110,139,12188,249,
kenett,12,15,33,360,438,11889,798,
fe,12,15,44,349,0,12327,349,
rw,12,16,368,25,438,11889,463,
goni,12,16,295,98,151,12176,249,
kenett,12,16,40,353,431,11896,784,
fe,12,16,46,347,0,12327,347,
rw,12,17,370,23,467,11860,490,
goni,12,17,303,90,170,12157,260,
kenett,12,17,43,350,428,11899,778,
fe,12,17,49,344,0,12327,344,
rw,12,18,375,18,491,11836,509,
goni,12,18,308,85,180,12147,265,
kenett,12,18,46,347,425,11902,772,
fe,12,18,52,341,0,12327,341,
rw,12,19,377,16,523,11804,539,
goni,12,19,309,84,197,12130,281,
kenett,12,19,223,170,251,12076,421,
fe,12,19,55,338,0,12327,338,
rw,12,20,378,15,549,11778,564,
goni,12,20,311,82,199,12128,281,
kenett,12,20,239,154,235,12092,389,
fe,12,20,58,335,0,12327,335,
rw,12,21,379,14,573,11754,587,
goni,12,21,318,75,216,12111,291,
kenett,12,21,244,149,230,12097,379,
fe,12,21,61,332,0,12327,332,
rw,12,22,380,13,599,11728,612,
goni,12,22,323,70,213,12114,283,
kenett,12,22,248,145,226,12101,371,
fe,12,22,64,329,0,12327,329,
rw,12,23,382,11,622,11705,633,
goni,12,23,330,63,223,12104,286,
kenett,12,23,251,142,223,12104,365,
fe,12,23,65,328,0,12327,328,
rw,12,24,383,10,647,11680,657,
goni,12,24,335,58,227,12100,285,
kenett,12,24,256,137,218,12109,355,
fe,12,24,68,325,0,12327,325,
rw,12,25,383,10,670,11657,680,
goni,12,25,339,54,232,12095,286,
kenett,12,25,244,149,230,12097,379,
fe,12,25,70,323,0,12327,323,
rw,12,26,383,10,689,11638,699,
goni,12,26,341,52,232,12095,284,
kenett,12,26,256,137,218,12109,355,
fe,12,26,73,320,0,12327,320,
rw,12,27,383,10,704,11623,714,
goni,12,27,343,50,242,12085,292,
kenett,12,27,267,126,207,12120,333,
fe,12,27,74,319,0,12327,319,
rw,12,28,383,10,726,11601,736,
goni,12,28,347,46,253,12074,299,
kenett,12,28,258,135,216,12111,351,
fe,12,28,77,316,0,12327,316,
rw,12,29,385,8,743,11584,751,
goni,12,29,353,40,269,12058,309,
kenett,12,29,257,136,217,12110,353,
fe,12,29,79,314,0,12327,314,
rw,12,30,387,6,769,11558,775,
goni,12,30,356,37,268,12059,305,
kenett,12,30,262,131,212,12115,343,
fe,12,30,82,311,0,12327,311,
rw,12,31,387,6,792,11535,798,
goni,12,31,360,33,276,12051,309,
kenett,12,31,266,127,208,12119,335,
fe,12,31,84,309,0,12327,309,
rw,12,32,387,6,816,11511,822,
goni,12,32,365,28,281,12046,309,
kenett,12,32,263,130,211,12116,341,
fe,12,32,86,307,0,12327,307,
rw,12,33,387,6,831,11496,837,
goni,12,33,366,27,290,12037,317,
kenett,12,33,270,123,204,12123,327,
fe,12,33,88,305,0,12327,305,
rw,12,34,387,6,847,11480,853,
goni,12,34,368,25,301,12026,326,
kenett,12,34,273,120,201,12126,321,
fe,12,34,91,302,0,12327,302,
rw,12,35,388,5,869,11458,874,
goni,12,35,371,22,302,12025,324,
kenett,12,35,270,123,204,12123,327,
fe,12,35,93,300,0,12327,300,
rw,12,36,390,3,888,11439,891,
goni,12,36,372,21,311,12016,332,
kenett,12,36,278,115,196,12131,311,
fe,12,36,94,299,0,12327,299,
rw,12,37,391,2,905,11422,907,
goni,12,37,373,20,320,12007,340,
kenett,12,37,271,122,203,12124,325,
fe,12,37,97,296,0,12327,296,
rw,12,38,391,2,920,11407,922,
goni,12,38,375,18,327,12000,345,
kenett,12,38,279,114,195,12132,309,
fe,12,38,100,293,0,12327,293,
rw,12,39,391,2,947,11380,949,
goni,12,39,375,18,325,12002,343,
kenett,12,39,281,112,193,12134,305,
fe,12,39,101,292,0,12327,292,
rw,12,40,391,2,965,11362,967,
goni,12,40,374,19,331,11996,350,
kenett,12,40,275,118,199,12128,317,
fe,12,40,103,290,0,12327,290,
rw,12,41,391,2,982,11345,984,
goni,12,41,373,20,337,11990,357,
kenett,12,41,279,114,195,12132,309,
fe,12,41,104,289,0,12327,289,
rw,12,42,391,2,1002,11325,1004,
goni,12,42,374,19,345,11982,364,
kenett,12,42,282,111,192,12135,303,
fe,12,42,105,288,0,12327,288,
rw,12,43,391,2,1016,11311,1018,
goni,12,43,375,18,352,11975,370,
kenett,12,43,279,114,195,12132,309,
fe,12,43,107,286,0,12327,286,
rw,12,44,391,2,1038,11289,1040,
goni,12,44,377,16,360,11967,376,
kenett,12,44,277,116,197,12130,313,
fe,12,44,110,283,0,12327,283,
rw,12,45,392,1,1053,11274,1054,
goni,12,45,377,16,365,11962,381,
kenett,12,45,280,113,194,12133,307,
fe,12,45,112,281,0,12327,281,
rw,12,46,392,1,1072,11255,1073,
goni,12,46,376,17,372,11955,389,
kenett,12,46,281,112,193,12134,305,
fe,12,46,114,279,0,12327,279,
rw,12,47,392,1,1087,11240,1088,
goni,12,47,378,15,380,11947,395,
kenett,12,47,281,112,193,12134,305,
fe,12,47,116,277,0,12327,277,
rw,12,48,393,0,1103,11224,1103,
goni,12,48,379,14,388,11939,402,
kenett,12,48,288,105,186,12141,291,
fe,12,48,118,275,0,12327,275,
rw,12,49,393,0,1120,11207,1120,
goni,12,49,381,12,388,11939,400,
kenett,12,49,285,108,189,12138,297,
fe,12,49,119,274,0,12327,274,
rw,12,50,393,0,1133,11194,1133,
goni,12,50,382,11,391,11936,402,
kenett,12,50,281,112,193,12134,305,
fe,12,50,121,272,0,12327,272,
rw,13,1,69,324,29,12298,353,
goni,13,1,7,386,1,12326,387,
kenett,13,1,10,383,227,12100,610,
fe,13,1,3,390,0,12327,390,
rw,13,2,111,282,65,12262,347,
goni,13,2,31,362,7,12320,369,
kenett,13,2,10,383,302,12025,685,
fe,13,2,5,388,0,12327,388,
rw,13,3,162,231,95,12232,326,
goni,13,3,60,333,16,12311,349,
kenett,13,3,21,372,351,11976,723,
fe,13,3,8,385,0,12327,385,
rw,13,4,202,191,129,12198,320,
goni,13,4,84,309,24,12303,333,
kenett,13,4,16,377,401,11926,778,
fe,13,4,11,382,0,12327,382,
rw,13,5,231,162,166,12161,328,
goni,13,5,123,270,32,12295,302,
kenett,13,5,14,379,406,11921,785,
fe,13,5,14,379,0,12327,379,
rw,13,6,254,139,196,12131,335,
goni,13,6,132,261,47,12280,308,
kenett,13,6,14,379,421,11906,800,
fe,13,6,17,376,0,12327,376,
rw,13,7,272,121,234,12093,355,
goni,13,7,152,241,63,12264,304,
kenett,13,7,17,376,445,11882,821,
fe,13,7,20,373,0,12327,373,
rw,13,8,284,109,266,12061,375,
goni,13,8,173,220,71,12256,291,
kenett,13,8,13,380,449,11878,829,
fe,13,8,23,370,0,12327,370,
rw,13,9,302,91,294,12033,385,
goni,13,9,197,196,81,12246,277,
kenett,13,9,22,371,443,11884,814,
fe,13,9,26,367,0,12327,367,
rw,13,10,319,74,322,12005,396,
goni,13,10,221,172,98,12229,270,
kenett,13,10,25,368,440,11887,808,
fe,13,10,29,364,0,12327,364,
rw,13,11,328,65,353,11974,418,
goni,13,11,232,161,108,12219,269,
kenett,13,11,22,371,446,11881,817,
fe,13,11,31,362,0,12327,362,
rw,13,12,342,51,379,11948,430,
goni,13,12,251,142,128,12199,270,
kenett,13,12,24,369,447,11880,816,
fe,13,12,34,359,0,12327,359,
rw,13,13,345,48,405,11922,453,
goni,13,13,254,139,144,12183,283,
kenett,13,13,36,357,435,11892,792,
fe,13,13,37,356,0,12327,356,
rw,13,14,354,39,427,11900,466,
goni,13,14,269,124,157,12170,281,
kenett,13,14,32,361,439,11888,800,
fe,13,14,40,353,0,12327,353,
rw,13,15,355,38,462,11865,500,
goni,13,15,270,123,155,12172,278,
kenett,13,15,40,353,431,11896,784,
fe,13,15,42,351,0,12327,351,
rw,13,16,357,36,489,11838,525,
goni,13,16,287,106,168,12159,274,
kenett,13,16,29,364,442,11885,806,
fe,13,16,45,348,0,12327,348,
rw,13,17,358,35,519,11808,554,
goni,13,17,299,94,177,12150,271,
kenett,13,17,205,188,269,12058,457,
fe,13,17,47,346,0,12327,346,
rw,13,18,364,29,539,11788,568,
goni,13,18,305,88,181,12146,269,
kenett,13,18,219,174,255,12072,429,
fe,13,18,49,344,0,12327,344,
rw,13,19,368,25,566,11761,591,
goni,13,19,308,85,191,12136,276,
kenett,13,19,216,177,258,12069,435,
fe,13,19,52,341,0,12327,341,
rw,13,20,371,22,594,11733,616,
goni,13,20,316,77,186,12141,263,
kenett,13,20,214,179,260,12067,439,
fe,13,20,55,338,0,12327,338,
rw,13,21,375,18,617,11710,635,
goni,13,21,320,73,209,12118,282,
kenett,13,21,217,176,257,12070,433,
fe,13,21,57,336,0,12327,336,
rw,13,22,378,15,638,11689,653,
goni,13,22,324,69,216,12111,285,
kenett,13,22,231,162,243,12084,405,
fe,13,22,59,334,0,12327,334,
rw,13,23,379,14,660,11667,674,
goni,13,23,327,66,226,12101,292,
kenett,13,23,235,158,239,12088,397,
fe,13,23,62,331,0,12327,331,
rw,13,24,381,12,684,11643,696,
goni,13,24,333,60,233,12094,293,
kenett,13,24,234,159,240,12087,399,
fe,13,24,65,328,0,12327,328,
rw,13,25,381,12,703,11624,715,
goni,13,25,338,55,258,12069,313,
kenett,13,25,238,155,236,12091,391,
fe,13,25,67,326,0,12327,326,
rw,13,26,382,11,725,11602,736,
goni,13,26,341,52,262,12065,314,
kenett,13,26,238,155,236,12091,391,
fe,13,26,68,325,0,12327,325,
rw,13,27,382,11,743,11584,754,
goni,13,27,343,50,266,12061,316,
kenett,13,27,241,152,233,12094,385,
fe,13,27,70,323,0,12327,323,
rw,13,28,384,9,764,11563,773,
goni,13,28,348,45,273,12054,318,
kenett,13,28,238,155,236,12091,391,
fe,13,28,72,321,0,12327,321,
rw,13,29,384,9,786,11541,795,
goni,13,29,353,40,278,12049,318,
kenett,13,29,237,156,237,12090,393,
fe,13,29,73,320,0,12327,320,
rw,13,30,386,7,812,11515,819,
goni,13,30,356,37,283,12044,320,
kenett,13,30,236,157,238,12089,395,
fe,13,30,75,318,0,12327,318,
rw,13,31,388,5,827,11500,832,
goni,13,31,360,33,296,12031,329,
kenett,13,31,240,153,234,12093,387,
fe,13,31,78,315,0,12327,315,
rw,13,32,389,4,849,11478,853,
goni,13,32,362,31,305,12022,336,
kenett,13,32,241,152,233,12094,385,
fe,13,32,81,312,0,12327,312,
rw,13,33,389,4,865,11462,869,
goni,13,33,364,29,315,12012,344,
kenett,13,33,244,149,230,12097,379,
fe,13,33,83,310,0,12327,310,
rw,13,34,389,4,886,11441,890,
goni,13,34,366,27,330,11997,357,
kenett,13,34,244,149,230,12097,379,
fe,13,34,86,307,0,12327,307,
rw,13,35,390,3,900,11427,903,
goni,13,35,366,27,343,11984,370,
kenett,13,35,242,151,232,12095,383,
fe,13,35,88,305,0,12327,305,
rw,13,36,390,3,918,11409,921,
goni,13,36,366,27,342,11985,369,
kenett,13,36,242,151,232,12095,383,
fe,13,36,90,303,0,12327,303,
rw,13,37,390,3,930,11397,933,
goni,13,37,367,26,348,11979,374,
kenett,13,37,247,146,227,12100,373,
fe,13,37,92,301,0,12327,301,
rw,13,38,390,3,949,11378,952,
goni,13,38,368,25,358,11969,383,
kenett,13,38,249,144,225,12102,369,
fe,13,38,94,299,0,12327,299,
rw,13,39,391,2,965,11362,967,
goni,13,39,369,24,371,11956,395,
kenett,13,39,251,142,223,12104,365,
fe,13,39,97,296,0,12327,296,
rw,13,40,391,2,980,11347,982,
goni,13,40,370,23,384,11943,407,
kenett,13,40,249,144,225,12102,369,
fe,13,40,99,294,0,12327,294,
rw,13,41,391,2,1002,11325,1004,
goni,13,41,369,24,392,11935,416,
kenett,13,41,249,144,225,12102,369,
fe,13,41,101,292,0,12327,292,
rw,13,42,391,2,1019,11308,1021,
goni,13,42,372,21,394,11933,415,
kenett,13,42,249,144,225,12102,369,
fe,13,42,102,291,0,12327,291,
rw,13,43,391,2,1037,11290,1039,
goni,13,43,375,18,401,11926,419,
kenett,13,43,256,137,218,12109,355,
fe,13,43,103,290,0,12327,290,
rw,13,44,391,2,1057,11270,1059,
goni,13,44,378,15,404,11923,419,
kenett,13,44,254,139,220,12107,359,
fe,13,44,104,289,0,12327,289,
rw,13,45,391,2,1070,11257,1072,
goni,13,45,381,12,409,11918,421,
kenett,13,45,251,142,223,12104,365,
fe,13,45,107,286,0,12327,286,
rw,13,46,392,1,1090,11237,1091,
goni,13,46,380,13,419,11908,432,
kenett,13,46,255,138,219,12108,357,
fe,13,46,110,283,0,12327,283,
rw,13,47,393,0,1106,11221,1106,
goni,13,47,382,11,422,11905,433,
kenett,13,47,261,132,213,12114,345,
fe,13,47,112,281,0,12327,281,
rw,13,48,393,0,1116,11211,1116,
goni,13,48,383,10,426,11901,436,
kenett,13,48,254,139,220,12107,359,
fe,13,48,114,279,0,12327,279,
rw,13,49,393,0,1130,11197,1130,
goni,13,49,383,10,431,11896,441,
kenett,13,49,259,134,215,12112,349,
fe,13,49,114,279,0,12327,279,
rw,13,50,393,0,1145,11182,1145,
goni,13,50,382,11,436,11891,447,
kenett,13,50,256,137,218,12109,355,
fe,13,50,117,276,0,12327,276,
rw,14,1,71,322,24,12303,346,
goni,14,1,10,383,1,12326,384,
kenett,14,1,14,379,190,12137,569,
fe,14,1,3,390,0,12327,390,
rw,14,2,138,255,48,12279,303,
goni,14,2,22,371,4,12323,375,
kenett,14,2,17,376,319,12008,695,
fe,14,2,6,387,0,12327,387,
rw,14,3,179,214,79,12248,293,
goni,14,3,60,333,15,12312,348,
kenett,14,3,21,372,378,11949,750,
fe,14,3,8,385,0,12327,385,
rw,14,4,211,182,118,12209,300,
goni,14,4,91,302,23,12304,325,
kenett,14,4,18,375,426,11901,801,
fe,14,4,11,382,0,12327,382,
rw,14,5,242,151,150,12177,301,
goni,14,5,122,271,40,12287,311,
kenett,14,5,22,371,443,11884,814,
fe,14,5,14,379,0,12327,379,
rw,14,6,269,124,176,12151,300,
goni,14,6,150,243,54,12273,297,
kenett,14,6,31,362,437,11890,799,
fe,14,6,17,376,0,12327,376,
rw,14,7,296,97,207,12120,304,
goni,14,7,166,227,69,12258,296,
kenett,14,7,138,255,336,11991,591,
fe,14,7,20,373,0,12327,373,
rw,14,8,314,79,234,12093,313,
goni,14,8,186,207,80,12247,287,
kenett,14,8,137,256,337,11990,593,
fe,14,8,23,370,0,12327,370,
rw,14,9,321,72,267,12060,339,
goni,14,9,199,194,93,12234,287,
kenett,14,9,153,240,321,12006,561,
fe,14,9,26,367,0,12327,367,
rw,14,10,335,58,291,12036,349,
goni,14,10,229,164,101,12226,265,
kenett,14,10,163,230,311,12016,541,
fe,14,10,29,364,0,12327,364,
rw,14,11,343,50,320,12007,370,
goni,14,11,248,145,114,12213,259,
kenett,14,11,179,214,295,12032,509,
fe,14,11,31,362,0,12327,362,
rw,14,12,353,40,347,11980,387,
goni,14,12,267,126,129,12198,255,
kenett,14,12,183,210,291,12036,501,
fe,14,12,34,359,0,12327,359,
rw,14,13,359,34,374,11953,408,
goni,14,13,270,123,141,12186,264,
kenett,14,13,199,194,275,12052,469,
fe,14,13,37,356,0,12327,356,
rw,14,14,365,28,397,11930,425,
goni,14,14,282,111,149,12178,260,
kenett,14,14,204,189,270,12057,459,
fe,14,14,38,355,0,12327,355,
rw,14,15,370,23,427,11900,450,
goni,14,15,290,103,157,12170,260,
kenett,14,15,201,192,273,12054,465,
fe,14,15,41,352,0,12327,352,
rw,14,16,372,21,452,11875,473,
goni,14,16,303,90,165,12162,255,
kenett,14,16,202,191,272,12055,463,
fe,14,16,44,349,0,12327,349,
rw,14,17,376,17,477,11850,494,
goni,14,17,307,86,179,12148,265,
kenett,14,17,218,175,256,12071,431,
fe,14,17,47,346,0,12327,346,
rw,14,18,379,14,503,11824,517,
goni,14,18,316,77,183,12144,260,
kenett,14,18,216,177,258,12069,435,
fe,14,18,49,344,0,12327,344,
rw,14,19,379,14,533,11794,547,
goni,14,19,323,70,194,12133,264,
kenett,14,19,225,168,249,12078,417,
fe,14,19,51,342,0,12327,342,
rw,14,20,380,13,556,11771,569,
goni,14,20,327,66,194,12133,260,
kenett,14,20,223,170,251,12076,421,
fe,14,20,53,340,0,12327,340,
rw,14,21,382,11,576,11751,587,
goni,14,21,333,60,204,12123,264,
kenett,14,21,232,161,242,12085,403,
fe,14,21,56,337,0,12327,337,
rw,14,22,382,11,601,11726,612,
goni,14,22,335,58,207,12120,265,
kenett,14,22,232,161,242,12085,403,
fe,14,22,58,335,0,12327,335,
rw,14,23,383,10,627,11700,637,
goni,14,23,344,49,225,12102,274,
kenett,14,23,233,160,241,12086,401,
fe,14,23,61,332,0,12327,332,
rw,14,24,384,9,642,11685,651,
goni,14,24,347,46,232,12095,278,
kenett,14,24,230,163,244,12083,407,
fe,14,24,63,330,0,12327,330,
rw,14,25,385,8,659,11668,667,
goni,14,25,348,45,235,12092,280,
kenett,14,25,244,149,230,12097,379,
fe,14,25,66,327,0,12327,327,
rw,14,26,387,6,683,11644,689,
goni,14,26,354,39,241,12086,280,
kenett,14,26,236,157,238,12089,395,
fe,14,26,69,324,0,12327,324,
rw,14,27,388,5,710,11617,715,
goni,14,27,355,38,243,12084,281,
kenett,14,27,241,152,233,12094,385,
fe,14,27,72,321,0,12327,321,
rw,14,28,390,3,730,11597,733,
goni,14,28,357,36,258,12069,294,
kenett,14,28,248,145,226,12101,371,
fe,14,28,73,320,0,12327,320,
rw,14,29,390,3,746,11581,749,
goni,14,29,361,32,264,12063,296,
kenett,14,29,243,150,231,12096,381,
fe,14,29,76,317,0,12327,317,
rw,14,30,390,3,767,11560,770,
goni,14,30,363,30,268,12059,298,
kenett,14,30,250,143,224,12103,367,
fe,14,30,78,315,0,12327,315,
rw,14,31,390,3,787,11540,790,
goni,14,31,362,31,272,12055,303,
kenett,14,31,254,139,220,12107,359,
fe,14,31,81,312,0,12327,312,
rw,14,32,390,3,807,11520,810,
goni,14,32,361,32,278,12049,310,
kenett,14,32,257,136,217,12110,353,
fe,14,32,83,310,0,12327,310,
rw,14,33,390,3,827,11500,830,
goni,14,33,365,28,285,12042,313,
kenett,14,33,263,130,211,12116,341,
fe,14,33,85,308,0,12327,308,
rw,14,34,390,3,838,11489,841,
goni,14,34,367,26,286,12041,312,
kenett,14,34,264,129,210,12117,339,
fe,14,34,87,306,0,12327,306,
rw,14,35,390,3,851,11476,854,
goni,14,35,367,26,300,12027,326,
kenett,14,35,266,127,208,12119,335,
fe,14,35,89,304,0,12327,304,
rw,14,36,390,3,876,11451,879,
goni,14,36,372,21,308,12019,329,
kenett,14,36,270,123,204,12123,327,
fe,14,36,91,302,0,12327,302,
rw,14,37,390,3,893,11434,896,
goni,14,37,375,18,320,12007,338,
kenett,14,37,269,124,205,12122,329,
fe,14,37,93,300,0,12327,300,
rw,14,38,390,3,913,11414,916,
goni,14,38,376,17,320,12007,337,
kenett,14,38,274,119,200,12127,319,
fe,14,38,95,298,0,12327,298,
rw,14,39,390,3,937,11390,940,
goni,14,39,376,17,325,12002,342,
kenett,14,39,277,116,197,12130,313,
fe,14,39,97,296,0,12327,296,
rw,14,40,390,3,954,11373,957,
goni,14,40,377,16,324,12003,340,
kenett,14,40,278,115,196,12131,311,
fe,14,40,99,294,0,12327,294,
rw,14,41,391,2,978,11349,980,
goni,14,41,376,17,346,11981,363,
kenett,14,41,278,115,196,12131,311,
fe,14,41,102,291,0,12327,291,
rw,14,42,392,1,992,11335,993,
goni,14,42,377,16,354,11973,370,
kenett,14,42,276,117,198,12129,315,
fe,14,42,105,288,0,12327,288,
rw,14,43,392,1,1005,11322,1006,
goni,14,43,377,16,355,11972,371,
kenett,14,43,273,120,201,12126,321,
fe,14,43,108,285,0,12327,285,
rw,14,44,392,1,1029,11298,1030,
goni,14,44,377,16,356,11971,372,
kenett,14,44,280,113,194,12133,307,
fe,14,44,111,282,0,12327,282,
rw,14,45,392,1,1048,11279,1049,
goni,14,45,377,16,366,11961,382,
kenett,14,45,284,109,190,12137,299,
fe,14,45,113,280,0,12327,280,
rw,14,46,393,0,1066,11261,1066,
goni,14,46,380,13,372,11955,385,
kenett,14,46,278,115,196,12131,311,
fe,14,46,115,278,0,12327,278,
rw,14,47,393,0,1081,11246,1081,
goni,14,47,380,13,387,11940,400,
kenett,14,47,276,117,198,12129,315,
fe,14,47,117,276,0,12327,276,
rw,14,48,393,0,1107,11220,1107,
goni,14,48,380,13,402,11925,415,
kenett,14,48,276,117,198,12129,315,
fe,14,48,118,275,0,12327,275,
rw,14,49,393,0,1122,11205,1122,
goni,14,49,381,12,402,11925,414,
kenett,14,49,272,121,202,12125,323,
fe,14,49,121,272,0,12327,272,
rw,14,50,393,0,1138,11189,1138,
goni,14,50,381,12,402,11925,414,
kenett,14,50,271,122,203,12124,325,
fe,14,50,121,272,0,12327,272,
rw,15,1,55,338,35,12292,373,
goni,15,1,13,380,3,12324,383,
kenett,15,1,11,382,169,12158,551,
fe,15,1,3,390,0,12327,390,
rw,15,2,119,274,61,12266,335,
goni,15,2,30,363,7,12320,370,
kenett,15,2,17,376,334,11993,710,
fe,15,2,6,387,0,12327,387,
rw,15,3,164,229,87,12240,316,
goni,15,3,63,330,15,12312,345,
kenett,15,3,12,381,378,11949,759,
fe,15,3,9,384,0,12327,384,
rw,15,4,204,189,115,12212,304,
goni,15,4,85,308,23,12304,331,
kenett,15,4,20,373,394,11933,767,
fe,15,4,12,381,0,12327,381,
rw,15,5,233,160,152,12175,312,
goni,15,5,115,278,30,12297,308,
kenett,15,5,18,375,420,11907,795,
fe,15,5,15,378,0,12327,378,
rw,15,6,259,134,176,12151,310,
goni,15,6,148,245,40,12287,285,
kenett,15,6,19,374,440,11887,814,
fe,15,6,18,375,0,12327,375,
rw,15,7,283,110,197,12130,307,
goni,15,7,162,231,50,12277,281,
kenett,15,7,18,375,450,11877,825,
fe,15,7,21,372,0,12327,372,
rw,15,8,297,96,229,12098,325,
goni,15,8,177,216,58,12269,274,
kenett,15,8,21,372,447,11880,819,
fe,15,8,24,369,0,12327,369,
rw,15,9,311,82,259,12068,341,
goni,15,9,193,200,75,12252,275,
kenett,15,9,20,373,448,11879,821,
fe,15,9,26,367,0,12327,367,
rw,15,10,326,67,287,12040,354,
goni,15,10,215,178,96,12231,274,
kenett,15,10,17,376,454,11873,830,
fe,15,10,29,364,0,12327,364,
rw,15,11,339,54,309,12018,363,
goni,15,11,238,155,109,12218,264,
kenett,15,11,166,227,308,12019,535,
fe,15,11,32,361,0,12327,361,
rw,15,12,346,47,337,11990,384,
goni,15,12,254,139,109,12218,248,
kenett,15,12,176,217,298,12029,515,
fe,15,12,35,358,0,12327,358,
rw,15,13,354,39,362,11965,401,
goni,15,13,265,128,123,12204,251,
kenett,15,13,187,206,287,12040,493,
fe,15,13,38,355,0,12327,355,
rw,15,14,357,36,385,11942,421,
goni,15,14,280,113,140,12187,253,
kenett,15,14,182,211,292,12035,503,
fe,15,14,41,352,0,12327,352,
rw,15,15,360,33,406,11921,439,
goni,15,15,291,102,147,12180,249,
kenett,15,15,199,194,275,12052,469,
fe,15,15,44,349,0,12327,349,
rw,15,16,365,28,433,11894,461,
goni,15,16,303,90,149,12178,239,
kenett,15,16,196,197,278,12049,475,
fe,15,16,47,346,0,12327,346,
rw,15,17,371,22,459,11868,481,
goni,15,17,307,86,158,12169,244,
kenett,15,17,206,187,268,12059,455,
fe,15,17,49,344,0,12327,344,
rw,15,18,374,19,471,11856,490,
goni,15,18,321,72,157,12170,229,
kenett,15,18,196,197,278,12049,475,
fe,15,18,52,341,0,12327,341,
rw,15,19,377,16,495,11832,511,
goni,15,19,329,64,158,12169,222,
kenett,15,19,203,190,271,12056,461,
fe,15,19,54,339,0,12327,339,
rw,15,20,379,14,520,11807,534,
goni,15,20,332,61,168,12159,229,
kenett,15,20,211,182,263,12064,445,
fe,15,20,57,336,0,12327,336,
rw,15,21,379,14,545,11782,559,
goni,15,21,338,55,174,12153,229,
kenett,15,21,218,175,256,12071,431,
fe,15,21,60,333,0,12327,333,
rw,15,22,380,13,564,11763,577,
goni,15,22,345,48,183,12144,231,
kenett,15,22,232,161,242,12085,403,
fe,15,22,62,331,0,12327,331,
rw,15,23,381,12,588,11739,600,
goni,15,23,346,47,201,12126,248,
kenett,15,23,234,159,240,12087,399,
fe,15,23,65,328,0,12327,328,
rw,15,24,383,10,610,11717,620,
goni,15,24,349,44,215,12112,259,
kenett,15,24,228,165,246,12081,411,
fe,15,24,67,326,0,12327,326,
rw,15,25,385,8,625,11702,633,
goni,15,25,355,38,227,12100,265,
kenett,15,25,226,167,248,12079,415,
fe,15,25,69,324,0,12327,324,
rw,15,26,386,7,641,11686,648,
goni,15,26,357,36,231,12096,267,
kenett,15,26,235,158,239,12088,397,
fe,15,26,71,322,0,12327,322,
rw,15,27,386,7,659,11668,666,
goni,15,27,359,34,234,12093,268,
kenett,15,27,238,155,236,12091,391,
fe,15,27,74,319,0,12327,319,
rw,15,28,387,6,682,11645,688,
goni,15,28,358,35,252,12075,287,
kenett,15,28,251,142,223,12104,365,
fe,15,28,77,316,0,12327,316,
rw,15,29,389,4,705,11622,709,
goni,15,29,360,33,259,12068,292,
kenett,15,29,242,151,232,12095,383,
fe,15,29,79,314,0,12327,314,
rw,15,30,389,4,728,11599,732,
goni,15,30,363,30,260,12067,290,
kenett,15,30,241,152,233,12094,385,
fe,15,30,82,311,0,12327,311,
rw,15,31,390,3,748,11579,751,
goni,15,31,365,28,269,12058,297,
kenett,15,31,255,138,219,12108,357,
fe,15,31,85,308,0,12327,308,
rw,15,32,390,3,763,11564,766,
goni,15,32,368,25,280,12047,305,
kenett,15,32,260,133,214,12113,347,
fe,15,32,86,307,0,12327,307,
rw,15,33,390,3,782,11545,785,
goni,15,33,369,24,289,12038,313,
kenett,15,33,261,132,213,12114,345,
fe,15,33,89,304,0,12327,304,
rw,15,34,390,3,807,11520,810,
goni,15,34,370,23,296,12031,319,
kenett,15,34,264,129,210,12117,339,
fe,15,34,91,302,0,12327,302,
rw,15,35,390,3,824,11503,827,
goni,15,35,373,20,299,12028,319,
kenett,15,35,261,132,213,12114,345,
fe,15,35,93,300,0,12327,300,
rw,15,36,391,2,837,11490,839,
goni,15,36,373,20,299,12028,319,
kenett,15,36,255,138,219,12108,357,
fe,15,36,95,298,0,12327,298,
rw,15,37,391,2,860,11467,862,
goni,15,37,373,20,306,12021,326,
kenett,15,37,257,136,217,12110,353,
fe,15,37,97,296,0,12327,296,
rw,15,38,391,2,872,11455,874,
goni,15,38,375,18,313,12014,331,
kenett,15,38,265,128,209,12118,337,
fe,15,38,99,294,0,12327,294,
rw,15,39,391,2,894,11433,896,
goni,15,39,375,18,319,12008,337,
kenett,15,39,259,134,215,12112,349,
fe,15,39,101,292,0,12327,292,
rw,15,40,391,2,921,11406,923,
goni,15,40,374,19,316,12011,335,
kenett,15,40,261,132,213,12114,345,
fe,15,40,103,290,0,12327,290,
rw,15,41,391,2,934,11393,936,
goni,15,41,375,18,318,12009,336,
kenett,15,41,254,139,220,12107,359,
fe,15,41,105,288,0,12327,288,
rw,15,42,391,2,959,11368,961,
goni,15,42,378,15,328,11999,343,
kenett,15,42,259,134,215,12112,349,
fe,15,42,108,285,0,12327,285,
rw,15,43,391,2,976,11351,978,
goni,15,43,378,15,336,11991,351,
kenett,15,43,256,137,218,12109,355,
fe,15,43,111,282,0,12327,282,
rw,15,44,392,1,991,11336,992,
goni,15,44,378,15,341,11986,356,
kenett,15,44,258,135,216,12111,351,
fe,15,44,113,280,0,12327,280,
rw,15,45,392,1,1010,11317,1011,
goni,15,45,378,15,348,11979,363,
kenett,15,45,260,133,214,12113,347,
fe,15,45,115,278,0,12327,278,
rw,15,46,392,1,1028,11299,1029,
goni,15,46,379,14,349,11978,363,
kenett,15,46,271,122,203,12124,325,
fe,15,46,117,276,0,12327,276,
rw,15,47,392,1,1044,11283,1045,
goni,15,47,380,13,365,11962,378,
kenett,15,47,271,122,203,12124,325,
fe,15,47,117,276,0,12327,276,
rw,15,48,392,1,1065,11262,1066,
goni,15,48,382,11,374,11953,385,
kenett,15,48,273,120,201,12126,321,
fe,15,48,119,274,0,12327,274,
rw,15,49,393,0,1078,11249,1078,
goni,15,49,383,10,392,11935,402,
kenett,15,49,268,125,206,12121,331,
fe,15,49,121,272,0,12327,272,
rw,15,50,393,0,1091,11236,1091,
goni,15,50,384,9,396,11931,405,
kenett,15,50,272,121,202,12125,323,
fe,15,50,123,270,0,12327,270,
rw,16,1,72,321,27,12300,348,
goni,16,1,7,386,2,12325,388,
kenett,16,1,12,381,198,12129,579,
fe,16,1,3,390,0,12327,390,
rw,16,2,122,271,62,12265,333,
goni,16,2,27,366,9,12318,375,
kenett,16,2,16,377,335,11992,712,
fe,16,2,6,387,0,12327,387,
rw,16,3,171,222,95,12232,317,
goni,16,3,54,339,19,12308,358,
kenett,16,3,19,374,383,11944,757,
fe,16,3,9,384,0,12327,384,
rw,16,4,201,192,123,12204,315,
goni,16,4,96,297,31,12296,328,
kenett,16,4,18,375,390,11937,765,
fe,16,4,12,381,0,12327,381,
rw,16,5,226,167,155,12172,322,
goni,16,5,119,274,45,12282,319,
kenett,16,5,17,376,424,11903,800,
fe,16,5,15,378,0,12327,378,
rw,16,6,250,143,182,12145,325,
goni,16,6,142,251,52,12275,303,
kenett,16,6,14,379,439,11888,818,
fe,16,6,18,375,0,12327,375,
rw,16,7,276,117,213,12114,330,
goni,16,7,161,232,67,12260,299,
kenett,16,7,14,379,448,11879,827,
fe,16,7,21,372,0,12327,372,
rw,16,8,291,102,243,12084,345,
goni,16,8,179,214,82,12245,296,
kenett,16,8,15,378,453,11874,831,
fe,16,8,23,370,0,12327,370,
rw,16,9,303,90,268,12059,358,
goni,16,9,192,201,87,12240,288,
kenett,16,9,26,367,445,11882,812,
fe,16,9,26,367,0,12327,367,
rw,16,10,318,75,299,12028,374,
goni,16,10,210,183,97,12230,280,
kenett,16,10,34,359,437,11890,796,
fe,16,10,28,365,0,12327,365,
rw,16,11,334,59,325,12002,384,
goni,16,11,229,164,111,12216,275,
kenett,16,11,21,372,450,11877,822,
fe,16,11,31,362,0,12327,362,
rw,16,12,338,55,353,11974,408,
goni,16,12,241,152,119,12208,271,
kenett,16,12,34,359,437,11890,796,
fe,16,12,34,359,0,12327,359,
rw,16,13,347,46,381,11946,427,
goni,16,13,253,140,134,12193,274,
kenett,16,13,28,365,443,11884,808,
fe,16,13,37,356,0,12327,356,
rw,16,14,351,42,403,11924,445,
goni,16,14,266,127,149,12178,276,
kenett,16,14,40,353,431,11896,784,
fe,16,14,40,353,0,12327,353,
rw,16,15,355,38,435,11892,473,
goni,16,15,283,110,152,12175,262,
kenett,16,15,225,168,249,12078,417,
fe,16,15,43,350,0,12327,350,
rw,16,16,359,34,458,11869,492,
goni,16,16,290,103,155,12172,258,
kenett,16,16,224,169,250,12077,419,
fe,16,16,46,347,0,12327,347,
rw,16,17,366,27,482,11845,509,
goni,16,17,293,100,170,12157,270,
kenett,16,17,223,170,251,12076,421,
fe,16,17,48,345,0,12327,345,
rw,16,18,371,22,501,11826,523,
goni,16,18,300,93,173,12154,266,
kenett,16,18,231,162,243,12084,405,
fe,16,18,51,342,0,12327,342,
rw,16,19,375,18,528,11799,546,
goni,16,19,311,82,188,12139,270,
kenett,16,19,241,152,233,12094,385,
fe,16,19,54,339,0,12327,339,
rw,16,20,377,16,545,11782,561,
goni,16,20,320,73,182,12145,255,
kenett,16,20,237,156,237,12090,393,
fe,16,20,57,336,0,12327,336,
rw,16,21,379,14,572,11755,586,
goni,16,21,322,71,195,12132,266,
kenett,16,21,238,155,236,12091,391,
fe,16,21,60,333,0,12327,333,
rw,16,22,379,14,599,11728,613,
goni,16,22,329,64,202,12125,266,
kenett,16,22,239,154,235,12092,389,
fe,16,22,63,330,0,12327,330,
rw,16,23,380,13,625,11702,638,
goni,16,23,332,61,213,12114,274,
kenett,16,23,248,145,226,12101,371,
fe,16,23,66,327,0,12327,327,
rw,16,24,381,12,646,11681,658,
goni,16,24,335,58,218,12109,276,
kenett,16,24,243,150,231,12096,381,
fe,16,24,69,324,0,12327,324,
rw,16,25,382,11,657,11670,668,
goni,16,25,336,57,230,12097,287,
kenett,16,25,246,147,228,12099,375,
fe,16,25,71,322,0,12327,322,
rw,16,26,384,9,673,11654,682,
goni,16,26,338,55,236,12091,291,
kenett,16,26,254,139,220,12107,359,
fe,16,26,73,320,0,12327,320,
rw,16,27,385,8,691,11636,699,
goni,16,27,344,49,239,12088,288,
kenett,16,27,250,143,224,12103,367,
fe,16,27,75,318,0,12327,318,
rw,16,28,387,6,716,11611,722,
goni,16,28,347,46,252,12075,298,
kenett,16,28,251,142,223,12104,365,
fe,16,28,76,317,0,12327,317,
rw,16,29,387,6,736,11591,742,
goni,16,29,349,44,259,12068,303,
kenett,16,29,251,142,223,12104,365,
fe,16,29,78,315,0,12327,315,
rw,16,30,388,5,753,11574,758,
goni,16,30,350,43,269,12058,312,
kenett,16,30,252,141,222,12105,363,
fe,16,30,81,312,0,12327,312,
rw,16,31,389,4,774,11553,778,
goni,16,31,353,40,283,12044,323,
kenett,16,31,257,136,217,12110,353,
fe,16,31,84,309,0,12327,309,
rw,16,32,390,3,792,11535,795,
goni,16,32,352,41,287,12040,328,
kenett,16,32,262,131,212,12115,343,
fe,16,32,86,307,0,12327,307,
rw,16,33,390,3,809,11518,812,
goni,16,33,358,35,292,12035,327,
kenett,16,33,266,127,208,12119,335,
fe,16,33,88,305,0,12327,305,
rw,16,34,390,3,827,11500,830,
goni,16,34,361,32,296,12031,328,
kenett,16,34,265,128,209,12118,337,
fe,16,34,91,302,0,12327,302,
rw,16,35,390,3,851,11476,854,
goni,16,35,360,33,308,12019,341,
kenett,16,35,264,129,210,12117,339,
fe,16,35,94,299,0,12327,299,
rw,16,36,390,3,870,11457,873,
goni,16,36,364,29,309,12018,338,
kenett,16,36,268,125,206,12121,331,
fe,16,36,97,296,0,12327,296,
rw,16,37,390,3,889,11438,892,
goni,16,37,367,26,318,12009,344,
kenett,16,37,263,130,211,12116,341,
fe,16,37,100,293,0,12327,293,
rw,16,38,391,2,907,11420,909,
goni,16,38,365,28,321,12006,349,
kenett,16,38,267,126,207,12120,333,
fe,16,38,101,292,0,12327,292,
rw,16,39,391,2,925,11402,927,
goni,16,39,367,26,327,12000,353,
kenett,16,39,266,127,208,12119,335,
fe,16,39,102,291,0,12327,291,
rw,16,40,391,2,946,11381,948,
goni,16,40,367,26,335,11992,361,
kenett,16,40,267,126,207,12120,333,
fe,16,40,105,288,0,12327,288,
rw,16,41,391,2,962,11365,964,
goni,16,41,369,24,346,11981,370,
kenett,16,41,272,121,202,12125,323,
fe,16,41,107,286,0,12327,286,
rw,16,42,391,2,979,11348,981,
goni,16,42,370,23,347,11980,370,
kenett,16,42,270,123,204,12123,327,
fe,16,42,110,283,0,12327,283,
rw,16,43,392,1,994,11333,995,
goni,16,43,370,23,353,11974,376,
kenett,16,43,274,119,200,12127,319,
fe,16,43,111,282,0,12327,282,
rw,16,44,392,1,1013,11314,1014,
goni,16,44,369,24,366,11961,390,
kenett,16,44,269,124,205,12122,329,
fe,16,44,114,279,0,12327,279,
rw,16,45,392,1,1034,11293,1035,
goni,16,45,370,23,375,11952,398,
kenett,16,45,265,128,209,12118,337,
fe,16,45,115,278,0,12327,278,
rw,16,46,393,0,1049,11278,1049,
goni,16,46,373,20,384,11943,404,
kenett,16,46,266,127,208,12119,335,
fe,16,46,117,276,0,12327,276,
rw,16,47,393,0,1064,11263,1064,
goni,16,47,376,17,387,11940,404,
kenett,16,47,266,127,208,12119,335,
fe,16,47,118,275,0,12327,275,
rw,16,48,393,0,1081,11246,1081,
goni,16,48,377,16,396,11931,412,
kenett,16,48,270,123,204,12123,327,
fe,16,48,119,274,0,12327,274,
rw,16,49,393,0,1098,11229,1098,
goni,16,49,376,17,399,11928,416,
kenett,16,49,267,126,207,12120,333,
fe,16,49,122,271,0,12327,271,
rw,16,50,393,0,1113,11214,1113,
goni,16,50,378,15,407,11920,422,
kenett,16,50,271,122,203,12124,325,
fe,16,50,124,269,0,12327,269,
rw,17,1,64,329,32,12295,361,
goni,17,1,8,385,1,12326,386,
kenett,17,1,13,380,221,12106,601,
fe,17,1,3,390,0,12327,390,
rw,17,2,124,269,54,12273,323,
goni,17,2,34,359,6,12321,365,
kenett,17,2,20,373,319,12008,692,
fe,17,2,6,387,0,12327,387,
rw,17,3,169,224,84,12243,308,
goni,17,3,61,332,9,12318,341,
kenett,17,3,15,378,378,11949,756,
fe,17,3,9,384,0,12327,384,
rw,17,4,207,186,110,12217,296,
goni,17,4,89,304,19,12308,323,
kenett,17,4,19,374,410,11917,784,
fe,17,4,12,381,0,12327,381,
rw,17,5,237,156,150,12177,306,
goni,17,5,108,285,30,12297,315,
kenett,17,5,17,376,433,11894,809,
fe,17,5,15,378,0,12327,378,
rw,17,6,260,133,183,12144,316,
goni,17,6,140,253,41,12286,294,
kenett,17,6,20,373,439,11888,812,
fe,17,6,17,376,0,12327,376,
rw,17,7,283,110,213,12114,323,
goni,17,7,150,243,45,12282,288,
kenett,17,7,32,361,436,11891,797,
fe,17,7,20,373,0,12327,373,
rw,17,8,300,93,238,12089,331,
goni,17,8,178,215,55,12272,270,
kenett,17,8,30,363,438,11889,801,
fe,17,8,23,370,0,12327,370,
rw,17,9,314,79,270,12057,349,
goni,17,9,201,192,64,12263,256,
kenett,17,9,34,359,434,11893,793,
fe,17,9,26,367,0,12327,367,
rw,17,10,327,66,293,12034,359,
goni,17,10,231,162,77,12250,239,
kenett,17,10,26,367,442,11885,809,
fe,17,10,28,365,0,12327,365,
rw,17,11,337,56,323,12004,379,
goni,17,11,246,147,93,12234,240,
kenett,17,11,24,369,444,11883,813,
fe,17,11,31,362,0,12327,362,
rw,17,12,344,49,351,11976,400,
goni,17,12,259,134,105,12222,239,
kenett,17,12,25,368,443,11884,811,
fe,17,12,34,359,0,12327,359,
rw,17,13,352,41,375,11952,416,
goni,17,13,271,122,117,12210,239,
kenett,17,13,44,349,427,11900,776,
fe,17,13,37,356,0,12327,356,
rw,17,14,357,36,401,11926,437,
goni,17,14,276,117,132,12195,249,
kenett,17,14,32,361,439,11888,800,
fe,17,14,40,353,0,12327,353,
rw,17,15,363,30,428,11899,458,
goni,17,15,282,111,137,12190,248,
kenett,17,15,24,369,447,11880,816,
fe,17,15,42,351,0,12327,351,
rw,17,16,367,26,450,11877,476,
goni,17,16,289,104,150,12177,254,
kenett,17,16,45,348,426,11901,774,
fe,17,16,45,348,0,12327,348,
rw,17,17,369,24,475,11852,499,
goni,17,17,298,95,166,12161,261,
kenett,17,17,48,345,423,11904,768,
fe,17,17,48,345,0,12327,345,
rw,17,18,372,21,506,11821,527,
goni,17,18,307,86,161,12166,247,
kenett,17,18,220,173,254,12073,427,
fe,17,18,49,344,0,12327,344,
rw,17,19,376,17,527,11800,544,
goni,17,19,314,79,165,12162,244,
kenett,17,19,227,166,247,12080,413,
fe,17,19,52,341,0,12327,341,
rw,17,20,378,15,553,11774,568,
goni,17,20,319,74,176,12151,250,
kenett,17,20,229,164,245,12082,409,
fe,17,20,54,339,0,12327,339,
rw,17,21,381,12,579,11748,591,
goni,17,21,319,74,190,12137,264,
kenett,17,21,245,148,229,12098,377,
fe,17,21,57,336,0,12327,336,
rw,17,22,383,10,606,11721,616,
goni,17,22,325,68,190,12137,258,
kenett,17,22,242,151,232,12095,383,
fe,17,22,60,333,0,12327,333,
rw,17,23,384,9,624,11703,633,
goni,17,23,329,64,205,12122,269,
kenett,17,23,241,152,233,12094,385,
fe,17,23,63,330,0,12327,330,
rw,17,24,385,8,645,11682,653,
goni,17,24,334,59,207,12120,266,
kenett,17,24,239,154,235,12092,389,
fe,17,24,64,329,0,12327,329,
rw,17,25,388,5,666,11661,671,
goni,17,25,339,54,227,12100,281,
kenett,17,25,232,161,242,12085,403,
fe,17,25,67,326,0,12327,326,
rw,17,26,388,5,690,11637,695,
goni,17,26,336,57,233,12094,290,
kenett,17,26,241,152,233,12094,385,
fe,17,26,70,323,0,12327,323,
rw,17,27,388,5,714,11613,719,
goni,17,27,343,50,241,12086,291,
kenett,17,27,249,144,225,12102,369,
fe,17,27,71,322,0,12327,322,
rw,17,28,389,4,736,11591,740,
goni,17,28,345,48,249,12078,297,
kenett,17,28,245,148,229,12098,377,
fe,17,28,73,320,0,12327,320,
rw,17,29,390,3,754,11573,757,
goni,17,29,345,48,254,12073,302,
kenett,17,29,255,138,219,12108,357,
fe,17,29,76,317,0,12327,317,
rw,17,30,390,3,770,11557,773,
goni,17,30,353,40,269,12058,309,
kenett,17,30,257,136,217,12110,353,
fe,17,30,77,316,0,12327,316,
rw,17,31,390,3,795,11532,798,
goni,17,31,354,39,275,12052,314,
kenett,17,31,250,143,224,12103,367,
fe,17,31,80,313,0,12327,313,
rw,17,32,390,3,806,11521,809,
goni,17,32,358,35,277,12050,312,
kenett,17,32,255,138,219,12108,357,
fe,17,32,82,311,0,12327,311,
rw,17,33,390,3,817,11510,820,
goni,17,33,360,33,283,12044,316,
kenett,17,33,256,137,218,12109,355,
fe,17,33,85,308,0,12327,308,
rw,17,34,391,2,837,11490,839,
goni,17,34,361,32,288,12039,320,
kenett,17,34,254,139,220,12107,359,
fe,17,34,87,306,0,12327,306,
rw,17,35,391,2,859,11468,861,
goni,17,35,365,28,300,12027,328,
kenett,17,35,269,124,205,12122,329,
fe,17,35,90,303,0,12327,303,
rw,17,36,391,2,873,11454,875,
goni,17,36,368,25,311,12016,336,
kenett,17,36,266,127,208,12119,335,
fe,17,36,92,301,0,12327,301,
rw,17,37,391,2,888,11439,890,
goni,17,37,369,24,311,12016,335,
kenett,17,37,269,124,205,12122,329,
fe,17,37,95,298,0,12327,298,
rw,17,38,392,1,904,11423,905,
goni,17,38,371,22,322,12005,344,
kenett,17,38,254,139,220,12107,359,
fe,17,38,98,295,0,12327,295,
rw,17,39,392,1,919,11408,920,
goni,17,39,372,21,336,11991,357,
kenett,17,39,260,133,214,12113,347,
fe,17,39,100,293,0,12327,293,
rw,17,40,392,1,934,11393,935,
goni,17,40,374,19,339,11988,358,
kenett,17,40,261,132,213,12114,345,
fe,17,40,101,292,0,12327,292,
rw,17,41,392,1,952,11375,953,
goni,17,41,374,19,352,11975,371,
kenett,17,41,267,126,207,12120,333,
fe,17,41,104,289,0,12327,289,
rw,17,42,392,1,965,11362,966,
goni,17,42,376,17,346,11981,363,
kenett,17,42,266,127,208,12119,335,
fe,17,42,106,287,0,12327,287,
rw,17,43,393,0,981,11346,981,
goni,17,43,377,16,358,11969,374,
kenett,17,43,276,117,198,12129,315,
fe,17,43,107,286,0,12327,286,
rw,17,44,393,0,995,11332,995,
goni,17,44,378,15,364,11963,379,
kenett,17,44,265,128,209,12118,337,
fe,17,44,108,285,0,12327,285,
rw,17,45,393,0,1012,11315,1012,
goni,17,45,378,15,369,11958,384,
kenett,17,45,272,121,202,12125,323,
fe,17,45,111,282,0,12327,282,
rw,17,46,393,0,1025,11302,1025,
goni,17,46,379,14,379,11948,393,
kenett,17,46,274,119,200,12127,319,
fe,17,46,113,280,0,12327,280,
rw,17,47,393,0,1036,11291,1036,
goni,17,47,379,14,385,11942,399,
kenett,17,47,274,119,200,12127,319,
fe,17,47,115,278,0,12327,278,
rw,17,48,393,0,1053,11274,1053,
goni,17,48,379,14,388,11939,402,
kenett,17,48,276,117,198,12129,315,
fe,17,48,116,277,0,12327,277,
rw,17,49,393,0,1064,11263,1064,
goni,17,49,381,12,394,11933,406,
kenett,17,49,278,115,196,12131,311,
fe,17,49,119,274,0,12327,274,
rw,17,50,393,0,1074,11253,1074,
goni,17,50,382,11,411,11916,422,
kenett,17,50,280,113,194,12133,307,
fe,17,50,119,274,0,12327,274,
rw,18,1,74,319,22,12305,341,
goni,18,1,8,385,1,12326,386,
kenett,18,1,12,381,204,12123,585,
fe,18,1,3,390,0,12327,390,
rw,18,2,132,261,50,12277,311,
goni,18,2,37,356,4,12323,360,
kenett,18,2,17,376,328,11999,704,
fe,18,2,6,387,0,12327,387,
rw,18,3,173,220,87,12240,307,
goni,18,3,64,329,8,12319,337,
kenett,18,3,14,379,397,11930,776,
fe,18,3,9,384,0,12327,384,
rw,18,4,202,191,121,12206,312,
goni,18,4,97,296,24,12303,320,
kenett,18,4,15,378,423,11904,801,
fe,18,4,11,382,0,12327,382,
rw,18,5,227,166,146,12181,312,
goni,18,5,129,264,40,12287,304,
kenett,18,5,14,379,433,11894,812,
fe,18,5,14,379,0,12327,379,
rw,18,6,253,140,171,12156,311,
goni,18,6,148,245,50,12277,295,
kenett,18,6,15,378,435,11892,813,
fe,18,6,17,376,0,12327,376,
rw,18,7,272,121,198,12129,319,
goni,18,7,172,221,61,12266,282,
kenett,18,7,17,376,439,11888,815,
fe,18,7,20,373,0,12327,373,
rw,18,8,299,94,225,12102,319,
goni,18,8,192,201,77,12250,278,
kenett,18,8,19,374,443,11884,817,
fe,18,8,23,370,0,12327,370,
rw,18,9,309,84,251,12076,335,
goni,18,9,211,182,85,12242,267,
kenett,18,9,22,371,440,11887,811,
fe,18,9,25,368,0,12327,368,
rw,18,10,318,75,274,12053,349,
goni,18,10,228,165,96,12231,261,
kenett,18,10,17,376,445,11882,821,
fe,18,10,27,366,0,12327,366,
rw,18,11,329,64,301,12026,365,
goni,18,11,252,141,106,12221,247,
kenett,18,11,21,372,444,11883,816,
fe,18,11,30,363,0,12327,363,
rw,18,12,339,54,325,12002,379,
goni,18,12,266,127,116,12211,243,
kenett,18,12,49,344,419,11908,763,
fe,18,12,33,360,0,12327,360,
rw,18,13,350,43,358,11969,401,
goni,18,13,276,117,135,12192,252,
kenett,18,13,50,343,421,11906,764,
fe,18,13,36,357,0,12327,357,
rw,18,14,354,39,386,11941,425,
goni,18,14,282,111,149,12178,260,
kenett,18,14,201,192,273,12054,465,
fe,18,14,39,354,0,12327,354,
rw,18,15,357,36,406,11921,442,
goni,18,15,290,103,155,12172,258,
kenett,18,15,200,193,274,12053,467,
fe,18,15,41,352,0,12327,352,
rw,18,16,364,29,434,11893,463,
goni,18,16,296,97,166,12161,263,
kenett,18,16,208,185,266,12061,451,
fe,18,16,44,349,0,12327,349,
rw,18,17,370,23,462,11865,485,
goni,18,17,307,86,171,12156,257,
kenett,18,17,213,180,261,12066,441,
fe,18,17,46,347,0,12327,347,
rw,18,18,372,21,490,11837,511,
goni,18,18,309,84,175,12152,259,
kenett,18,18,227,166,247,12080,413,
fe,18,18,49,344,0,12327,344,
rw,18,19,373,20,520,11807,540,
goni,18,19,315,78,181,12146,259,
kenett,18,19,236,157,238,12089,395,
fe,18,19,52,341,0,12327,341,
rw,18,20,376,17,537,11790,554,
goni,18,20,324,69,187,12140,256,
kenett,18,20,234,159,240,12087,399,
fe,18,20,55,338,0,12327,338,
rw,18,21,380,13,558,11769,571,
goni,18,21,327,66,194,12133,260,
kenett,18,21,236,157,238,12089,395,
fe,18,21,58,335,0,12327,335,
rw,18,22,381,12,571,11756,583,
goni,18,22,332,61,199,12128,260,
kenett,18,22,243,150,231,12096,381,
fe,18,22,61,332,0,12327,332,
rw,18,23,381,12,593,11734,605,
goni,18,23,333,60,213,12114,273,
kenett,18,23,240,153,234,12093,387,
fe,18,23,64,329,0,12327,329,
rw,18,24,383,10,616,11711,626,
goni,18,24,339,54,226,12101,280,
kenett,18,24,239,154,235,12092,389,
fe,18,24,67,326,0,12327,326,
rw,18,25,384,9,635,11692,644,
goni,18,25,350,43,238,12089,281,
kenett,18,25,244,149,230,12097,379,
fe,18,25,70,323,0,12327,323,
rw,18,26,385,8,648,11679,656,
goni,18,26,351,42,246,12081,288,
kenett,18,26,260,133,214,12113,347,
fe,18,26,73,320,0,12327,320,
rw,18,27,385,8,669,11658,677,
goni,18,27,354,39,255,12072,294,
kenett,18,27,252,141,222,12105,363,
fe,18,27,75,318,0,12327,318,
rw,18,28,386,7,697,11630,704,
goni,18,28,359,34,273,12054,307,
kenett,18,28,255,138,219,12108,357,
fe,18,28,76,317,0,12327,317,
rw,18,29,386,7,718,11609,725,
goni,18,29,359,34,275,12052,309,
kenett,18,29,255,138,219,12108,357,
fe,18,29,79,314,0,12327,314,
rw,18,30,386,7,743,11584,750,
goni,18,30,361,32,278,12049,310,
kenett,18,30,263,130,211,12116,341,
fe,18,30,81,312,0,12327,312,
rw,18,31,387,6,768,11559,774,
goni,18,31,362,31,283,12044,314,
kenett,18,31,262,131,212,12115,343,
fe,18,31,84,309,0,12327,309,
rw,18,32,388,5,787,11540,792,
goni,18,32,364,29,289,12038,318,
kenett,18,32,261,132,213,12114,345,
fe,18,32,86,307,0,12327,307,
rw,18,33,388,5,798,11529,803,
goni,18,33,364,29,294,12033,323,
kenett,18,33,262,131,212,12115,343,
fe,18,33,87,306,0,12327,306,
rw,18,34,388,5,816,11511,821,
goni,18,34,368,25,294,12033,319,
kenett,18,34,262,131,212,12115,343,
fe,18,34,89,304,0,12327,304,
rw,18,35,390,3,831,11496,834,
goni,18,35,368,25,296,12031,321,
kenett,18,35,266,127,208,12119,335,
fe,18,35,91,302,0,12327,302,
rw,18,36,390,3,851,11476,854,
goni,18,36,368,25,303,12024,328,
kenett,18,36,262,131,212,12115,343,
fe,18,36,93,300,0,12327,300,
rw,18,37,390,3,872,11455,875,
goni,18,37,370,23,306,12021,329,
kenett,18,37,256,137,218,12109,355,
fe,18,37,96,297,0,12327,297,
rw,18,38,391,2,899,11428,901,
goni,18,38,371,22,321,12006,343,
kenett,18,38,256,137,218,12109,355,
fe,18,38,98,295,0,12327,295,
rw,18,39,391,2,920,11407,922,
goni,18,39,372,21,331,11996,352,
kenett,18,39,258,135,216,12111,351,
fe,18,39,101,292,0,12327,292,
rw,18,40,392,1,941,11386,942,
goni,18,40,372,21,338,11989,359,
kenett,18,40,258,135,216,12111,351,
fe,18,40,104,289,0,12327,289,
rw,18,41,392,1,955,11372,956,
goni,18,41,375,18,352,11975,370,
kenett,18,41,262,131,212,12115,343,
fe,18,41,107,286,0,12327,286,
rw,18,42,392,1,983,11344,984,
goni,18,42,377,16,362,11965,378,
kenett,18,42,262,131,212,12115,343,
fe,18,42,108,285,0,12327,285,
rw,18,43,393,0,1004,11323,1004,
goni,18,43,378,15,371,11956,386,
kenett,18,43,265,128,209,12118,337,
fe,18,43,110,283,0,12327,283,
rw,18,44,393,0,1014,11313,1014,
goni,18,44,376,17,383,11944,400,
kenett,18,44,262,131,212,12115,343,
fe,18,44,112,281,0,12327,281,
rw,18,45,393,0,1030,11297,1030,
goni,18,45,378,15,388,11939,403,
kenett,18,45,263,130,211,12116,341,
fe,18,45,115,278,0,12327,278,
rw,18,46,393,0,1048,11279,1048,
goni,18,46,379,14,401,11926,415,
kenett,18,46,261,132,213,12114,345,
fe,18,46,117,276,0,12327,276,
rw,18,47,393,0,1072,11255,1072,
goni,18,47,377,16,403,11924,419,
kenett,18,47,268,125,206,12121,331,
fe,18,47,119,274,0,12327,274,
rw,18,48,393,0,1083,11244,1083,
goni,18,48,378,15,402,11925,417,
kenett,18,48,266,127,208,12119,335,
fe,18,48,122,271,0,12327,271,
rw,18,49,393,0,1101,11226,1101,
goni,18,49,379,14,400,11927,414,
kenett,18,49,266,127,208,12119,335,
fe,18,49,123,270,0,12327,270,
rw,18,50,393,0,1120,11207,1120,
goni,18,50,381,12,404,11923,416,
kenett,18,50,266,127,208,12119,335,
fe,18,50,124,269,0,12327,269,
rw,19,1,61,332,37,12290,369,
goni,19,1,6,387,1,12326,388,
kenett,19,1,10,383,209,12118,592,
fe,19,1,3,390,0,12327,390,
rw,19,2,111,282,73,12254,355,
goni,19,2,23,370,8,12319,378,
kenett,19,2,16,377,308,12019,685,
fe,19,2,6,387,0,12327,387,
rw,19,3,155,238,105,12222,343,
goni,19,3,52,341,14,12313,355,
kenett,19,3,15,378,372,11955,750,
fe,19,3,8,385,0,12327,385,
rw,19,4,192,201,134,12193,335,
goni,19,4,80,313,22,12305,335,
kenett,19,4,21,372,396,11931,768,
fe,19,4,11,382,0,12327,382,
rw,19,5,232,161,163,12164,324,
goni,19,5,110,283,33,12294,316,
kenett,19,5,19,374,425,11902,799,
fe,19,5,14,379,0,12327,379,
rw,19,6,259,134,190,12137,324,
goni,19,6,135,258,47,12280,305,
kenett,19,6,22,371,422,11905,793,
fe,19,6,16,377,0,12327,377,
rw,19,7,280,113,225,12102,338,
goni,19,7,156,237,57,12270,294,
kenett,19,7,24,369,438,11889,807,
fe,19,7,19,374,0,12327,374,
rw,19,8,299,94,255,12072,349,
goni,19,8,178,215,70,12257,285,
kenett,19,8,20,373,445,11882,818,
fe,19,8,22,371,0,12327,371,
rw,19,9,313,80,289,12038,369,
goni,19,9,190,203,90,12237,293,
kenett,19,9,32,361,439,11888,800,
fe,19,9,25,368,0,12327,368,
rw,19,10,326,67,309,12018,376,
goni,19,10,215,178,102,12225,280,
kenett,19,10,28,365,443,11884,808,
fe,19,10,28,365,0,12327,365,
rw,19,11,336,57,331,11996,388,
goni,19,11,231,162,116,12211,278,
kenett,19,11,24,369,447,11880,816,
fe,19,11,31,362,0,12327,362,
rw,19,12,345,48,362,11965,410,
goni,19,12,251,142,129,12198,271,
kenett,19,12,35,358,436,11891,794,
fe,19,12,34,359,0,12327,359,
rw,19,13,354,39,388,11939,427,
goni,19,13,259,134,134,12193,268,
kenett,19,13,185,208,289,12038,497,
fe,19,13,37,356,0,12327,356,
rw,19,14,359,34,418,11909,452,
goni,19,14,260,133,141,12186,274,
kenett,19,14,192,201,282,12045,483,
fe,19,14,40,353,0,12327,353,
rw,19,15,367,26,439,11888,465,
goni,19,15,279,114,149,12178,263,
kenett,19,15,185,208,289,12038,497,
fe,19,15,41,352,0,12327,352,
rw,19,16,371,22,461,11866,483,
goni,19,16,291,102,151,12176,253,
kenett,19,16,199,194,275,12052,469,
fe,19,16,44,349,0,12327,349,
rw,19,17,374,19,493,11834,512,
goni,19,17,300,93,160,12167,253,
kenett,19,17,207,186,267,12060,453,
fe,19,17,47,346,0,12327,346,
rw,19,18,376,17,519,11808,536,
goni,19,18,312,81,166,12161,247,
kenett,19,18,211,182,263,12064,445,
fe,19,18,49,344,0,12327,344,
rw,19,19,377,16,545,11782,561,
goni,19,19,319,74,180,12147,254,
kenett,19,19,215,178,259,12068,437,
fe,19,19,52,341,0,12327,341,
rw,19,20,380,13,570,11757,583,
goni,19,20,323,70,191,12136,261,
kenett,19,20,223,170,251,12076,421,
fe,19,20,55,338,0,12327,338,
rw,19,21,382,11,592,11735,603,
goni,19,21,325,68,205,12122,273,
kenett,19,21,232,161,242,12085,403,
fe,19,21,57,336,0,12327,336,
rw,19,22,383,10,610,11717,620,
goni,19,22,335,58,208,12119,266,
kenett,19,22,231,162,243,12084,405,
fe,19,22,59,334,0,12327,334,
rw,19,23,383,10,632,11695,642,
goni,19,23,336,57,229,12098,286,
kenett,19,23,234,159,240,12087,399,
fe,19,23,61,332,0,12327,332,
rw,19,24,384,9,655,11672,664,
goni,19,24,342,51,237,12090,288,
kenett,19,24,242,151,232,12095,383,
fe,19,24,64,329,0,12327,329,
rw,19,25,384,9,669,11658,678,
goni,19,25,344,49,241,12086,290,
kenett,19,25,243,150,231,12096,381,
fe,19,25,66,327,0,12327,327,
rw,19,26,385,8,691,11636,699,
goni,19,26,348,45,250,12077,295,
kenett,19,26,244,149,230,12097,379,
fe,19,26,68,325,0,12327,325,
rw,19,27,386,7,708,11619,715,
goni,19,27,351,42,261,12066,303,
kenett,19,27,254,139,220,12107,359,
fe,19,27,70,323,0,12327,323,
rw,19,28,387,6,726,11601,732,
goni,19,28,355,38,267,12060,305,
kenett,19,28,251,142,223,12104,365,
fe,19,28,73,320,0,12327,320,
rw,19,29,387,6,741,11586,747,
goni,19,29,356,37,276,12051,313,
kenett,19,29,263,130,211,12116,341,
fe,19,29,75,318,0,12327,318,
rw,19,30,387,6,753,11574,759,
goni,19,30,354,39,285,12042,324,
kenett,19,30,265,128,209,12118,337,
fe,19,30,76,317,0,12327,317,
rw,19,31,387,6,771,11556,777,
goni,19,31,364,29,287,12040,316,
kenett,19,31,265,128,209,12118,337,
fe,19,31,78,315,0,12327,315,
rw,19,32,387,6,789,11538,795,
goni,19,32,364,29,297,12030,326,
kenett,19,32,271,122,203,12124,325,
fe,19,32,80,313,0,12327,313,
rw,19,33,387,6,801,11526,807,
goni,19,33,364,29,305,12022,334,
kenett,19,33,268,125,206,12121,331,
fe,19,33,81,312,0,12327,312,
rw,19,34,387,6,820,11507,826,
goni,19,34,362,31,311,12016,342,
kenett,19,34,266,127,208,12119,335,
fe,19,34,83,310,0,12327,310,
rw,19,35,387,6,834,11493,840,
goni,19,35,362,31,312,12015,343,
kenett,19,35,267,126,207,12120,333,
fe,19,35,85,308,0,12327,308,
rw,19,36,388,5,852,11475,857,
goni,19,36,371,22,315,12012,337,
kenett,19,36,263,130,211,12116,341,
fe,19,36,88,305,0,12327,305,
rw,19,37,388,5,870,11457,875,
goni,19,37,375,18,326,12001,344,
kenett,19,37,270,123,204,12123,327,
fe,19,37,89,304,0,12327,304,
rw,19,38,389,4,884,11443,888,
goni,19,38,373,20,332,11995,352,
kenett,19,38,265,128,209,12118,337,
fe,19,38,92,301,0,12327,301,
rw,19,39,390,3,904,11423,907,
goni,19,39,374,19,342,11985,361,
kenett,19,39,264,129,210,12117,339,
fe,19,39,94,299,0,12327,299,
rw,19,40,391,2,925,11402,927,
goni,19,40,372,21,348,11979,369,
kenett,19,40,275,118,199,12128,317,
fe,19,40,95,298,0,12327,298,
rw,19,41,391,2,938,11389,940,
goni,19,41,375,18,361,11966,379,
kenett,19,41,284,109,190,12137,299,
fe,19,41,98,295,0,12327,295,
rw,19,42,391,2,952,11375,954,
goni,19,42,377,16,361,11966,377,
kenett,19,42,285,108,189,12138,297,
fe,19,42,101,292,0,12327,292,
rw,19,43,391,2,971,11356,973,
goni,19,43,378,15,365,11962,380,
kenett,19,43,279,114,195,12132,309,
fe,19,43,103,290,0,12327,290,
rw,19,44,391,2,994,11333,996,
goni,19,44,381,12,376,11951,388,
kenett,19,44,279,114,195,12132,309,
fe,19,44,104,289,0,12327,289,
rw,19,45,391,2,1014,11313,1016,
goni,19,45,382,11,375,11952,386,
kenett,19,45,278,115,196,12131,311,
fe,19,45,106,287,0,12327,287,
rw,19,46,392,1,1029,11298,1030,
goni,19,46,384,9,378,11949,387,
kenett,19,46,280,113,194,12133,307,
fe,19,46,109,284,0,12327,284,
rw,19,47,392,1,1040,11287,1041,
goni,19,47,384,9,385,11942,394,
kenett,19,47,280,113,194,12133,307,
fe,19,47,111,282,0,12327,282,
rw,19,48,392,1,1058,11269,1059,
goni,19,48,384,9,387,11940,396,
kenett,19,48,282,111,192,12135,303,
fe,19,48,114,279,0,12327,279,
rw,19,49,392,1,1074,11253,1075,
goni,19,49,384,9,387,11940,396,
kenett,19,49,288,105,186,12141,291,
fe,19,49,117,276,0,12327,276,
rw,19,50,392,1,1092,11235,1093,
goni,19,50,386,7,400,11927,407,
kenett,19,50,290,103,184,12143,287,
fe,19,50,119,274,0,12327,274,
rw,20,1,63,330,36,12291,366,
goni,20,1,10,383,1,12326,384,
kenett,20,1,11,382,205,12122,587,
fe,20,1,3,390,0,12327,390,
rw,20,2,111,282,70,12257,352,
goni,20,2,30,363,6,12321,369,
kenett,20,2,17,376,322,12005,698,
fe,20,2,6,387,0,12327,387,
rw,20,3,145,248,101,12226,349,
goni,20,3,62,331,14,12313,345,
kenett,20,3,17,376,358,11969,734,
fe,20,3,8,385,0,12327,385,
rw,20,4,186,207,140,12187,347,
goni,20,4,86,307,20,12307,327,
kenett,20,4,18,375,417,11910,792,
fe,20,4,11,382,0,12327,382,
rw,20,5,219,174,165,12162,339,
goni,20,5,116,277,42,12285,319,
kenett,20,5,24,369,426,11901,795,
fe,20,5,14,379,0,12327,379,
rw,20,6,250,143,192,12135,335,
goni,20,6,143,250,55,12272,305,
kenett,20,6,23,370,433,11894,803,
fe,20,6,17,376,0,12327,376,
rw,20,7,274,119,217,12110,336,
goni,20,7,170,223,66,12261,289,
kenett,20,7,17,376,445,11882,821,
fe,20,7,20,373,0,12327,373,
rw,20,8,293,100,236,12091,336,
goni,20,8,188,205,78,12249,283,
kenett,20,8,17,376,448,11879,824,
fe,20,8,22,371,0,12327,371,
rw,20,9,314,79,259,12068,338,
goni,20,9,213,180,85,12242,265,
kenett,20,9,22,371,446,11881,817,
fe,20,9,25,368,0,12327,368,
rw,20,10,323,70,292,12035,362,
goni,20,10,224,169,103,12224,272,
kenett,20,10,14,379,454,11873,833,
fe,20,10,28,365,0,12327,365,
rw,20,11,330,63,318,12009,381,
goni,20,11,231,162,106,12221,268,
kenett,20,11,16,377,452,11875,829,
fe,20,11,30,363,0,12327,363,
rw,20,12,338,55,335,11992,390,
goni,20,12,244,149,118,12209,267,
kenett,20,12,19,374,449,11878,823,
fe,20,12,31,362,0,12327,362,
rw,20,13,345,48,370,11957,418,
goni,20,13,264,129,130,12197,259,
kenett,20,13,13,380,455,11872,835,
fe,20,13,33,360,0,12327,360,
rw,20,14,357,36,392,11935,428,
goni,20,14,276,117,148,12179,265,
kenett,20,14,15,378,453,11874,831,
fe,20,14,36,357,0,12327,357,
rw,20,15,365,28,411,11916,439,
goni,20,15,283,110,153,12174,263,
kenett,20,15,31,362,440,11887,802,
fe,20,15,37,356,0,12327,356,
rw,20,16,370,23,429,11898,452,
goni,20,16,292,101,158,12169,259,
kenett,20,16,31,362,440,11887,802,
fe,20,16,40,353,0,12327,353,
rw,20,17,374,19,458,11869,477,
goni,20,17,302,91,164,12163,255,
kenett,20,17,210,183,264,12063,447,
fe,20,17,43,350,0,12327,350,
rw,20,18,375,18,484,11843,502,
goni,20,18,308,85,174,12153,259,
kenett,20,18,221,172,253,12074,425,
fe,20,18,46,347,0,12327,347,
rw,20,19,376,17,515,11812,532,
goni,20,19,312,81,181,12146,262,
kenett,20,19,228,165,246,12081,411,
fe,20,19,48,345,0,12327,345,
rw,20,20,378,15,536,11791,551,
goni,20,20,321,72,192,12135,264,
kenett,20,20,230,163,244,12083,407,
fe,20,20,50,343,0,12327,343,
rw,20,21,378,15,558,11769,573,
goni,20,21,328,65,202,12125,267,
kenett,20,21,234,159,240,12087,399,
fe,20,21,53,340,0,12327,340,
rw,20,22,380,13,584,11743,597,
goni,20,22,329,64,209,12118,273,
kenett,20,22,236,157,238,12089,395,
fe,20,22,56,337,0,12327,337,
rw,20,23,382,11,607,11720,618,
goni,20,23,336,57,224,12103,281,
kenett,20,23,234,159,240,12087,399,
fe,20,23,58,335,0,12327,335,
rw,20,24,383,10,629,11698,639,
goni,20,24,338,55,239,12088,294,
kenett,20,24,241,152,233,12094,385,
fe,20,24,61,332,0,12327,332,
rw,20,25,387,6,646,11681,652,
goni,20,25,342,51,242,12085,293,
kenett,20,25,241,152,233,12094,385,
fe,20,25,64,329,0,12327,329,
rw,20,26,388,5,666,11661,671,
goni,20,26,346,47,246,12081,293,
kenett,20,26,244,149,230,12097,379,
fe,20,26,66,327,0,12327,327,
rw,20,27,388,5,689,11638,694,
goni,20,27,351,42,255,12072,297,
kenett,20,27,248,145,226,12101,371,
fe,20,27,68,325,0,12327,325,
rw,20,28,390,3,721,11606,724,
goni,20,28,352,41,260,12067,301,
kenett,20,28,243,150,231,12096,381,
fe,20,28,70,323,0,12327,323,
rw,20,29,390,3,739,11588,742,
goni,20,29,352,41,265,12062,306,
kenett,20,29,247,146,227,12100,373,
fe,20,29,73,320,0,12327,320,
rw,20,30,391,2,755,11572,757,
goni,20,30,352,41,275,12052,316,
kenett,20,30,249,144,225,12102,369,
fe,20,30,75,318,0,12327,318,
rw,20,31,391,2,779,11548,781,
goni,20,31,356,37,285,12042,322,
kenett,20,31,252,141,222,12105,363,
fe,20,31,77,316,0,12327,316,
rw,20,32,391,2,795,11532,797,
goni,20,32,355,38,288,12039,326,
kenett,20,32,258,135,216,12111,351,
fe,20,32,77,316,0,12327,316,
rw,20,33,391,2,825,11502,827,
goni,20,33,360,33,300,12027,333,
kenett,20,33,252,141,222,12105,363,
fe,20,33,79,314,0,12327,314,
rw,20,34,391,2,846,11481,848,
goni,20,34,364,29,306,12021,335,
kenett,20,34,255,138,219,12108,357,
fe,20,34,81,312,0,12327,312,
rw,20,35,391,2,864,11463,866,
goni,20,35,369,24,318,12009,342,
kenett,20,35,246,147,228,12099,375,
fe,20,35,82,311,0,12327,311,
rw,20,36,391,2,884,11443,886,
goni,20,36,370,23,323,12004,346,
kenett,20,36,252,141,222,12105,363,
fe,20,36,84,309,0,12327,309,
rw,20,37,391,2,897,11430,899,
goni,20,37,370,23,331,11996,354,
kenett,20,37,255,138,219,12108,357,
fe,20,37,87,306,0,12327,306,
rw,20,38,392,1,920,11407,921,
goni,20,38,372,21,333,11994,354,
kenett,20,38,256,137,218,12109,355,
fe,20,38,90,303,0,12327,303,
rw,20,39,392,1,940,11387,941,
goni,20,39,375,18,340,11987,358,
kenett,20,39,261,132,213,12114,345,
fe,20,39,92,301,0,12327,301,
rw,20,40,392,1,956,11371,957,
goni,20,40,376,17,360,11967,377,
kenett,20,40,266,127,208,12119,335,
fe,20,40,94,299,0,12327,299,
rw,20,41,392,1,980,11347,981,
goni,20,41,375,18,365,11962,383,
kenett,20,41,261,132,213,12114,345,
fe,20,41,97,296,0,12327,296,
rw,20,42,392,1,1000,11327,1001,
goni,20,42,374,19,369,11958,388,
kenett,20,42,268,125,206,12121,331,
fe,20,42,98,295,0,12327,295,
rw,20,43,392,1,1005,11322,1006,
goni,20,43,374,19,375,11952,394,
kenett,20,43,272,121,202,12125,323,
fe,20,43,101,292,0,12327,292,
rw,20,44,392,1,1029,11298,1030,
goni,20,44,375,18,388,11939,406,
kenett,20,44,270,123,204,12123,327,
fe,20,44,104,289,0,12327,289,
rw,20,45,392,1,1043,11284,1044,
goni,20,45,377,16,396,11931,412,
kenett,20,45,270,123,204,12123,327,
fe,20,45,105,288,0,12327,288,
rw,20,46,392,1,1058,11269,1059,
goni,20,46,380,13,395,11932,408,
kenett,20,46,271,122,203,12124,325,
fe,20,46,108,285,0,12327,285,
rw,20,47,392,1,1077,11250,1078,
goni,20,47,380,13,400,11927,413,
kenett,20,47,260,133,214,12113,347,
fe,20,47,110,283,0,12327,283,
rw,20,48,392,1,1092,11235,1093,
goni,20,48,380,13,411,11916,424,
kenett,20,48,265,128,209,12118,337,
fe,20,48,111,282,0,12327,282,
rw,20,49,392,1,1104,11223,1105,
goni,20,49,379,14,414,11913,428,
kenett,20,49,269,124,205,12122,329,
fe,20,49,114,279,0,12327,279,
rw,20,50,392,1,1128,11199,1129,
goni,20,50,380,13,418,11909,431,
kenett,20,50,266,127,208,12119,335,
fe,20,50,117,276,0,12327,276,
rw,21,1,62,331,36,12291,367,
goni,21,1,4,389,0,12327,389,
kenett,21,1,10,383,188,12139,571,
fe,21,1,3,390,0,12327,390,
rw,21,2,117,276,68,12259,344,
goni,21,2,25,368,3,12324,371,
kenett,21,2,14,379,334,11993,713,
fe,21,2,6,387,0,12327,387,
rw,21,3,168,225,89,12238,314,
goni,21,3,63,330,8,12319,338,
kenett,21,3,15,378,387,11940,765,
fe,21,3,9,384,0,12327,384,
rw,21,4,205,188,114,12213,302,
goni,21,4,95,298,19,12308,317,
kenett,21,4,15,378,402,11925,780,
fe,21,4,12,381,0,12327,381,
rw,21,5,229,164,146,12181,310,
goni,21,5,120,273,30,12297,303,
kenett,21,5,14,379,430,11897,809,
fe,21,5,15,378,0,12327,378,
rw,21,6,257,136,174,12153,310,
goni,21,6,142,251,45,12282,296,
kenett,21,6,20,373,439,11888,812,
fe,21,6,18,375,0,12327,375,
rw,21,7,283,110,203,12124,313,
goni,21,7,176,217,62,12265,279,
kenett,21,7,21,372,438,11889,810,
fe,21,7,21,372,0,12327,372,
rw,21,8,292,101,237,12090,338,
goni,21,8,193,200,87,12240,287,
kenett,21,8,13,380,449,11878,829,
fe,21,8,24,369,0,12327,369,
rw,21,9,309,84,261,12066,345,
goni,21,9,223,170,114,12213,284,
kenett,21,9,15,378,450,11877,828,
fe,21,9,27,366,0,12327,366,
rw,21,10,325,68,291,12036,359,
goni,21,10,235,158,130,12197,288,
kenett,21,10,18,375,450,11877,825,
fe,21,10,30,363,0,12327,363,
rw,21,11,333,60,316,12011,376,
goni,21,11,254,139,129,12198,268,
kenett,21,11,28,365,443,11884,808,
fe,21,11,33,360,0,12327,360,
rw,21,12,338,55,352,11975,407,
goni,21,12,260,133,147,12180,280,
kenett,21,12,41,352,430,11897,782,
fe,21,12,35,358,0,12327,358,
rw,21,13,347,46,384,11943,430,
goni,21,13,258,135,159,12168,294,
kenett,21,13,195,198,279,12048,477,
fe,21,13,37,356,0,12327,356,
rw,21,14,353,40,410,11917,450,
goni,21,14,275,118,169,12158,287,
kenett,21,14,207,186,267,12060,453,
fe,21,14,40,353,0,12327,353,
rw,21,15,358,35,433,11894,468,
goni,21,15,282,111,173,12154,284,
kenett,21,15,199,194,275,12052,469,
fe,21,15,43,350,0,12327,350,
rw,21,16,365,28,458,11869,486,
goni,21,16,288,105,192,12135,297,
kenett,21,16,211,182,263,12064,445,
fe,21,16,45,348,0,12327,348,
rw,21,17,366,27,490,11837,517,
goni,21,17,292,101,192,12135,293,
kenett,21,17,217,176,257,12070,433,
fe,21,17,48,345,0,12327,345,
rw,21,18,372,21,513,11814,534,
goni,21,18,304,89,209,12118,298,
kenett,21,18,220,173,254,12073,427,
fe,21,18,51,342,0,12327,342,
rw,21,19,374,19,529,11798,548,
goni,21,19,317,76,207,12120,283,
kenett,21,19,228,165,246,12081,411,
fe,21,19,53,340,0,12327,340,
rw,21,20,378,15,555,11772,570,
goni,21,20,322,71,209,12118,280,
kenett,21,20,231,162,243,12084,405,
fe,21,20,56,337,0,12327,337,
rw,21,21,379,14,587,11740,601,
goni,21,21,327,66,221,12106,287,
kenett,21,21,241,152,233,12094,385,
fe,21,21,58,335,0,12327,335,
rw,21,22,379,14,606,11721,620,
goni,21,22,330,63,228,12099,291,
kenett,21,22,236,157,238,12089,395,
fe,21,22,60,333,0,12327,333,
rw,21,23,381,12,630,11697,642,
goni,21,23,334,59,240,12087,299,
kenett,21,23,238,155,236,12091,391,
fe,21,23,63,330,0,12327,330,
rw,21,24,382,11,649,11678,660,
goni,21,24,337,56,239,12088,295,
kenett,21,24,244,149,230,12097,379,
fe,21,24,66,327,0,12327,327,
rw,21,25,382,11,670,11657,681,
goni,21,25,347,46,248,12079,294,
kenett,21,25,252,141,222,12105,363,
fe,21,25,68,325,0,12327,325,
rw,21,26,383,10,692,11635,702,
goni,21,26,352,41,259,12068,300,
kenett,21,26,250,143,224,12103,367,
fe,21,26,71,322,0,12327,322,
rw,21,27,385,8,707,11620,715,
goni,21,27,353,40,258,12069,298,
kenett,21,27,243,150,231,12096,381,
fe,21,27,74,319,0,12327,319,
rw,21,28,386,7,731,11596,738,
goni,21,28,358,35,271,12056,306,
kenett,21,28,255,138,219,12108,357,
fe,21,28,76,317,0,12327,317,
rw,21,29,386,7,749,11578,756,
goni,21,29,358,35,276,12051,311,
kenett,21,29,249,144,225,12102,369,
fe,21,29,79,314,0,12327,314,
rw,21,30,386,7,769,11558,776,
goni,21,30,358,35,276,12051,311,
kenett,21,30,254,139,220,12107,359,
fe,21,30,81,312,0,12327,312,
rw,21,31,387,6,796,11531,802,
goni,21,31,362,31,289,12038,320,
kenett,21,31,248,145,226,12101,371,
fe,21,31,84,309,0,12327,309,
rw,21,32,389,4,818,11509,822,
goni,21,32,363,30,294,12033,324,
kenett,21,32,263,130,211,12116,341,
fe,21,32,86,307,0,12327,307,
rw,21,33,389,4,837,11490,841,
goni,21,33,365,28,312,12015,340,
kenett,21,33,261,132,213,12114,345,
fe,21,33,88,305,0,12327,305,
rw,21,34,389,4,855,11472,859,
goni,21,34,370,23,315,12012,338,
kenett,21,34,263,130,211,12116,341,
fe,21,34,90,303,0,12327,303,
rw,21,35,390,3,874,11453,877,
goni,21,35,368,25,315,12012,340,
kenett,21,35,269,124,205,12122,329,
fe,21,35,93,300,0,12327,300,
rw,21,36,390,3,894,11433,897,
goni,21,36,373,20,321,12006,341,
kenett,21,36,268,125,206,12121,331,
fe,21,36,95,298,0,12327,298,
rw,21,37,390,3,914,11413,917,
goni,21,37,375,18,330,11997,348,
kenett,21,37,274,119,200,12127,319,
fe,21,37,98,295,0,12327,295,
rw,21,38,391,2,933,11394,935,
goni,21,38,376,17,332,11995,349,
kenett,21,38,269,124,205,12122,329,
fe,21,38,101,292,0,12327,292,
rw,21,39,391,2,953,11374,955,
goni,21,39,378,15,342,11985,357,
kenett,21,39,268,125,206,12121,331,
fe,21,39,102,291,0,12327,291,
rw,21,40,391,2,975,11352,977,
goni,21,40,377,16,345,11982,361,
kenett,21,40,267,126,207,12120,333,
fe,21,40,104,289,0,12327,289,
rw,21,41,391,2,993,11334,995,
goni,21,41,378,15,352,11975,367,
kenett,21,41,265,128,209,12118,337,
fe,21,41,106,287,0,12327,287,
rw,21,42,391,2,1011,11316,1013,
goni,21,42,379,14,364,11963,378,
kenett,21,42,273,120,201,12126,321,
fe,21,42,108,285,0,12327,285,
rw,21,43,391,2,1029,11298,1031,
goni,21,43,380,13,366,11961,379,
kenett,21,43,272,121,202,12125,323,
fe,21,43,109,284,0,12327,284,
rw,21,44,391,2,1043,11284,1045,
goni,21,44,380,13,370,11957,383,
kenett,21,44,269,124,205,12122,329,
fe,21,44,112,281,0,12327,281,
rw,21,45,391,2,1063,11264,1065,
goni,21,45,381,12,374,11953,386,
kenett,21,45,269,124,205,12122,329,
fe,21,45,115,278,0,12327,278,
rw,21,46,391,2,1081,11246,1083,
goni,21,46,381,12,378,11949,390,
kenett,21,46,277,116,197,12130,313,
fe,21,46,118,275,0,12327,275,
rw,21,47,391,2,1092,11235,1094,
goni,21,47,382,11,385,11942,396,
kenett,21,47,275,118,199,12128,317,
fe,21,47,119,274,0,12327,274,
rw,21,48,392,1,1107,11220,1108,
goni,21,48,384,9,394,11933,403,
kenett,21,48,270,123,204,12123,327,
fe,21,48,120,273,0,12327,273,
rw,21,49,392,1,1125,11202,1126,
goni,21,49,383,10,397,11930,407,
kenett,21,49,277,116,197,12130,313,
fe,21,49,123,270,0,12327,270,
rw,21,50,392,1,1150,11177,1151,
goni,21,50,384,9,402,11925,411,
kenett,21,50,270,123,204,12123,327,
fe,21,50,124,269,0,12327,269,
rw,22,1,62,331,36,12291,367,
goni,22,1,3,390,1,12326,391,
kenett,22,1,11,382,238,12089,620,
fe,22,1,3,390,0,12327,390,
rw,22,2,118,275,71,12256,346,
goni,22,2,25,368,8,12319,376,
kenett,22,2,18,375,321,12006,696,
fe,22,2,6,387,0,12327,387,
rw,22,3,165,228,98,12229,326,
goni,22,3,59,334,21,12306,355,
kenett,22,3,19,374,371,11956,745,
fe,22,3,9,384,0,12327,384,
rw,22,4,205,188,123,12204,311,
goni,22,4,96,297,26,12301,323,
kenett,22,4,15,378,402,11925,780,
fe,22,4,12,381,0,12327,381,
rw,22,5,225,168,147,12180,315,
goni,22,5,117,276,36,12291,312,
kenett,22,5,17,376,400,11927,776,
fe,22,5,15,378,0,12327,378,
rw,22,6,246,147,173,12154,320,
goni,22,6,135,258,47,12280,305,
kenett,22,6,16,377,410,11917,787,
fe,22,6,18,375,0,12327,375,
rw,22,7,273,120,203,12124,323,
goni,22,7,168,225,66,12261,291,
kenett,22,7,17,376,427,11900,803,
fe,22,7,21,372,0,12327,372,
rw,22,8,294,99,237,12090,336,
goni,22,8,184,209,70,12257,279,
kenett,22,8,16,377,440,11887,817,
fe,22,8,24,369,0,12327,369,
rw,22,9,313,80,265,12062,345,
goni,22,9,196,197,82,12245,279,
kenett,22,9,16,377,443,11884,820,
fe,22,9,26,367,0,12327,367,
rw,22,10,328,65,296,12031,361,
goni,22,10,211,182,91,12236,273,
kenett,22,10,16,377,446,11881,823,
fe,22,10,29,364,0,12327,364,
rw,22,11,340,53,318,12009,371,
goni,22,11,232,161,106,12221,267,
kenett,22,11,35,358,436,11891,794,
fe,22,11,32,361,0,12327,361,
rw,22,12,350,43,346,11981,389,
goni,22,12,242,151,122,12205,273,
kenett,22,12,174,219,300,12027,519,
fe,22,12,34,359,0,12327,359,
rw,22,13,356,37,367,11960,404,
goni,22,13,251,142,134,12193,276,
kenett,22,13,186,207,288,12039,495,
fe,22,13,37,356,0,12327,356,
rw,22,14,357,36,395,11932,431,
goni,22,14,272,121,143,12184,264,
kenett,22,14,194,199,280,12047,479,
fe,22,14,40,353,0,12327,353,
rw,22,15,364,29,422,11905,451,
goni,22,15,283,110,155,12172,265,
kenett,22,15,204,189,270,12057,459,
fe,22,15,41,352,0,12327,352,
rw,22,16,367,26,448,11879,474,
goni,22,16,296,97,164,12163,261,
kenett,22,16,209,184,265,12062,449,
fe,22,16,44,349,0,12327,349,
rw,22,17,368,25,471,11856,496,
goni,22,17,302,91,172,12155,263,
kenett,22,17,214,179,260,12067,439,
fe,22,17,47,346,0,12327,346,
rw,22,18,374,19,490,11837,509,
goni,22,18,309,84,176,12151,260,
kenett,22,18,213,180,261,12066,441,
fe,22,18,50,343,0,12327,343,
rw,22,19,375,18,508,11819,526,
goni,22,19,314,79,189,12138,268,
kenett,22,19,223,170,251,12076,421,
fe,22,19,53,340,0,12327,340,
rw,22,20,376,17,527,11800,544,
goni,22,20,327,66,208,12119,274,
kenett,22,20,219,174,255,12072,429,
fe,22,20,56,337,0,12327,337,
rw,22,21,379,14,546,11781,560,
goni,22,21,329,64,224,12103,288,
kenett,22,21,219,174,255,12072,429,
fe,22,21,59,334,0,12327,334,
rw,22,22,382,11,568,11759,579,
goni,22,22,331,62,224,12103,286,
kenett,22,22,228,165,246,12081,411,
fe,22,22,62,331,0,12327,331,
rw,22,23,383,10,590,11737,600,
goni,22,23,334,59,233,12094,292,
kenett,22,23,226,167,248,12079,415,
fe,22,23,63,330,0,12327,330,
rw,22,24,383,10,619,11708,629,
goni,22,24,336,57,243,12084,300,
kenett,22,24,239,154,235,12092,389,
fe,22,24,65,328,0,12327,328,
rw,22,25,386,7,640,11687,647,
goni,22,25,347,46,257,12070,303,
kenett,22,25,237,156,237,12090,393,
fe,22,25,66,327,0,12327,327,
rw,22,26,388,5,656,11671,661,
goni,22,26,350,43,258,12069,301,
kenett,22,26,229,164,245,12082,409,
fe,22,26,69,324,0,12327,324,
rw,22,27,388,5,687,11640,692,
goni,22,27,351,42,262,12065,304,
kenett,22,27,237,156,237,12090,393,
fe,22,27,71,322,0,12327,322,
rw,22,28,389,4,702,11625,706,
goni,22,28,353,40,276,12051,316,
kenett,22,28,235,158,239,12088,397,
fe,22,28,73,320,0,12327,320,
rw,22,29,390,3,720,11607,723,
goni,22,29,351,42,273,12054,315,
kenett,22,29,237,156,237,12090,393,
fe,22,29,75,318,0,12327,318,
rw,22,30,390,3,737,11590,740,
goni,22,30,353,40,277,12050,317,
kenett,22,30,241,152,233,12094,385,
fe,22,30,78,315,0,12327,315,
rw,22,31,390,3,758,11569,761,
goni,22,31,356,37,283,12044,320,
kenett,22,31,236,157,238,12089,395,
fe,22,31,81,312,0,12327,312,
rw,22,32,390,3,783,11544,786,
goni,22,32,358,35,288,12039,323,
kenett,22,32,249,144,225,12102,369,
fe,22,32,84,309,0,12327,309,
rw,22,33,390,3,805,11522,808,
goni,22,33,361,32,299,12028,331,
kenett,22,33,242,151,232,12095,383,
fe,22,33,85,308,0,12327,308,
rw,22,34,390,3,824,11503,827,
goni,22,34,361,32,313,12014,345,
kenett,22,34,238,155,236,12091,391,
fe,22,34,88,305,0,12327,305,
rw,22,35,390,3,846,11481,849,
goni,22,35,362,31,333,11994,364,
kenett,22,35,249,144,225,12102,369,
fe,22,35,91,302,0,12327,302,
rw,22,36,391,2,865,11462,867,
goni,22,36,364,29,340,11987,369,
kenett,22,36,246,147,228,12099,375,
fe,22,36,93,300,0,12327,300,
rw,22,37,391,2,880,11447,882,
goni,22,37,367,26,343,11984,369,
kenett,22,37,247,146,227,12100,373,
fe,22,37,96,297,0,12327,297,
rw,22,38,391,2,899,11428,901,
goni,22,38,370,23,349,11978,372,
kenett,22,38,251,142,223,12104,365,
fe,22,38,99,294,0,12327,294,
rw,22,39,391,2,913,11414,915,
goni,22,39,369,24,356,11971,380,
kenett,22,39,257,136,217,12110,353,
fe,22,39,102,291,0,12327,291,
rw,22,40,391,2,938,11389,940,
goni,22,40,371,22,365,11962,387,
kenett,22,40,251,142,223,12104,365,
fe,22,40,105,288,0,12327,288,
rw,22,41,392,1,958,11369,959,
goni,22,41,373,20,362,11965,382,
kenett,22,41,255,138,219,12108,357,
fe,22,41,107,286,0,12327,286,
rw,22,42,393,0,982,11345,982,
goni,22,42,373,20,369,11958,389,
kenett,22,42,250,143,224,12103,367,
fe,22,42,109,284,0,12327,284,
rw,22,43,393,0,993,11334,993,
goni,22,43,375,18,369,11958,387,
kenett,22,43,247,146,227,12100,373,
fe,22,43,111,282,0,12327,282,
rw,22,44,393,0,1010,11317,1010,
goni,22,44,376,17,375,11952,392,
kenett,22,44,250,143,224,12103,367,
fe,22,44,113,280,0,12327,280,
rw,22,45,393,0,1020,11307,1020,
goni,22,45,377,16,386,11941,402,
kenett,22,45,254,139,220,12107,359,
fe,22,45,115,278,0,12327,278,
rw,22,46,393,0,1032,11295,1032,
goni,22,46,379,14,390,11937,404,
kenett,22,46,254,139,220,12107,359,
fe,22,46,118,275,0,12327,275,
rw,22,47,393,0,1048,11279,1048,
goni,22,47,381,12,391,11936,403,
kenett,22,47,252,141,222,12105,363,
fe,22,47,121,272,0,12327,272,
rw,22,48,393,0,1066,11261,1066,
goni,22,48,382,11,399,11928,410,
kenett,22,48,260,133,214,12113,347,
fe,22,48,123,270,0,12327,270,
rw,22,49,393,0,1087,11240,1087,
goni,22,49,383,10,403,11924,413,
kenett,22,49,257,136,217,12110,353,
fe,22,49,124,269,0,12327,269,
rw,22,50,393,0,1095,11232,1095,
goni,22,50,384,9,404,11923,413,
kenett,22,50,264,129,210,12117,339,
fe,22,50,125,268,0,12327,268,
rw,23,1,65,328,31,12296,359,
goni,23,1,8,385,0,12327,385,
kenett,23,1,10,383,221,12106,604,
fe,23,1,3,390,0,12327,390,
rw,23,2,118,275,67,12260,342,
goni,23,2,26,367,1,12326,368,
kenett,23,2,16,377,332,11995,709,
fe,23,2,6,387,0,12327,387,
rw,23,3,159,234,101,12226,335,
goni,23,3,51,342,7,12320,349,
kenett,23,3,15,378,381,11946,759,
fe,23,3,9,384,0,12327,384,
rw,23,4,192,201,138,12189,339,
goni,23,4,73,320,18,12309,338,
kenett,23,4,18,375,384,11943,759,
fe,23,4,12,381,0,12327,381,
rw,23,5,223,170,167,12160,337,
goni,23,5,101,292,28,12299,320,
kenett,23,5,21,372,402,11925,774,
fe,23,5,15,378,0,12327,378,
rw,23,6,242,151,205,12122,356,
goni,23,6,131,262,38,12289,300,
kenett,23,6,17,376,424,11903,800,
fe,23,6,18,375,0,12327,375,
rw,23,7,272,121,226,12101,347,
goni,23,7,161,232,61,12266,293,
kenett,23,7,21,372,423,11904,795,
fe,23,7,21,372,0,12327,372,
rw,23,8,290,103,259,12068,362,
goni,23,8,189,204,74,12253,278,
kenett,23,8,18,375,435,11892,810,
fe,23,8,24,369,0,12327,369,
rw,23,9,307,86,289,12038,375,
goni,23,9,212,181,89,12238,270,
kenett,23,9,18,375,438,11889,813,
fe,23,9,27,366,0,12327,366,
rw,23,10,321,72,304,12023,376,
goni,23,10,231,162,108,12219,270,
kenett,23,10,20,373,436,11891,809,
fe,23,10,30,363,0,12327,363,
rw,23,11,331,62,331,11996,393,
goni,23,11,243,150,123,12204,273,
kenett,23,11,19,374,446,11881,820,
fe,23,11,32,361,0,12327,361,
rw,23,12,338,55,364,11963,419,
goni,23,12,248,145,140,12187,285,
kenett,23,12,21,372,447,11880,819,
fe,23,12,34,359,0,12327,359,
rw,23,13,346,47,392,11935,439,
goni,23,13,271,122,146,12181,268,
kenett,23,13,25,368,443,11884,811,
fe,23,13,37,356,0,12327,356,
rw,23,14,349,44,421,11906,465,
goni,23,14,275,118,149,12178,267,
kenett,23,14,32,361,439,11888,800,
fe,23,14,39,354,0,12327,354,
rw,23,15,353,40,447,11880,487,
goni,23,15,285,108,145,12182,253,
kenett,23,15,19,374,452,11875,826,
fe,23,15,42,351,0,12327,351,
rw,23,16,359,34,468,11859,502,
goni,23,16,290,103,161,12166,264,
kenett,23,16,22,371,449,11878,820,
fe,23,16,43,350,0,12327,350,
rw,23,17,365,28,490,11837,518,
goni,23,17,298,95,162,12165,257,
kenett,23,17,208,185,266,12061,451,
fe,23,17,46,347,0,12327,347,
rw,23,18,371,22,516,11811,538,
goni,23,18,307,86,174,12153,260,
kenett,23,18,218,175,256,12071,431,
fe,23,18,49,344,0,12327,344,
rw,23,19,375,18,535,11792,553,
goni,23,19,315,78,190,12137,268,
kenett,23,19,215,178,259,12068,437,
fe,23,19,52,341,0,12327,341,
rw,23,20,380,13,554,11773,567,
goni,23,20,325,68,194,12133,262,
kenett,23,20,221,172,253,12074,425,
fe,23,20,55,338,0,12327,338,
rw,23,21,380,13,568,11759,581,
goni,23,21,323,70,206,12121,276,
kenett,23,21,227,166,247,12080,413,
fe,23,21,58,335,0,12327,335,
rw,23,22,381,12,592,11735,604,
goni,23,22,324,69,216,12111,285,
kenett,23,22,222,171,252,12075,423,
fe,23,22,61,332,0,12327,332,
rw,23,23,382,11,614,11713,625,
goni,23,23,328,65,224,12103,289,
kenett,23,23,229,164,245,12082,409,
fe,23,23,64,329,0,12327,329,
rw,23,24,383,10,643,11684,653,
goni,23,24,329,64,240,12087,304,
kenett,23,24,230,163,244,12083,407,
fe,23,24,67,326,0,12327,326,
rw,23,25,384,9,661,11666,670,
goni,23,25,336,57,246,12081,303,
kenett,23,25,233,160,241,12086,401,
fe,23,25,69,324,0,12327,324,
rw,23,26,385,8,688,11639,696,
goni,23,26,339,54,246,12081,300,
kenett,23,26,243,150,231,12096,381,
fe,23,26,72,321,0,12327,321,
rw,23,27,385,8,713,11614,721,
goni,23,27,340,53,257,12070,310,
kenett,23,27,249,144,225,12102,369,
fe,23,27,74,319,0,12327,319,
rw,23,28,386,7,737,11590,744,
goni,23,28,344,49,271,12056,320,
kenett,23,28,249,144,225,12102,369,
fe,23,28,77,316,0,12327,316,
rw,23,29,386,7,760,11567,767,
goni,23,29,344,49,278,12049,327,
kenett,23,29,260,133,214,12113,347,
fe,23,29,78,315,0,12327,315,
rw,23,30,387,6,783,11544,789,
goni,23,30,348,45,292,12035,337,
kenett,23,30,254,139,220,12107,359,
fe,23,30,81,312,0,12327,312,
rw,23,31,388,5,808,11519,813,
goni,23,31,352,41,308,12019,349,
kenett,23,31,255,138,219,12108,357,
fe,23,31,83,310,0,12327,310,
rw,23,32,389,4,832,11495,836,
goni,23,32,351,42,311,12016,353,
kenett,23,32,250,143,224,12103,367,
fe,23,32,85,308,0,12327,308,
rw,23,33,389,4,845,11482,849,
goni,23,33,354,39,311,12016,350,
kenett,23,33,253,140,221,12106,361,
fe,23,33,88,305,0,12327,305,
rw,23,34,389,4,864,11463,868,
goni,23,34,361,32,314,12013,346,
kenett,23,34,255,138,219,12108,357,
fe,23,34,89,304,0,12327,304,
rw,23,35,389,4,880,11447,884,
goni,23,35,360,33,319,12008,352,
kenett,23,35,255,138,219,12108,357,
fe,23,35,91,302,0,12327,302,
rw,23,36,389,4,904,11423,908,
goni,23,36,364,29,321,12006,350,
kenett,23,36,248,145,226,12101,371,
fe,23,36,93,300,0,12327,300,
rw,23,37,390,3,922,11405,925,
goni,23,37,368,25,329,11998,354,
kenett,23,37,255,138,219,12108,357,
fe,23,37,96,297,0,12327,297,
rw,23,38,390,3,942,11385,945,
goni,23,38,370,23,341,11986,364,
kenett,23,38,255,138,219,12108,357,
fe,23,38,99,294,0,12327,294,
rw,23,39,391,2,959,11368,961,
goni,23,39,370,23,348,11979,371,
kenett,23,39,260,133,214,12113,347,
fe,23,39,102,291,0,12327,291,
rw,23,40,391,2,973,11354,975,
goni,23,40,372,21,351,11976,372,
kenett,23,40,261,132,213,12114,345,
fe,23,40,105,288,0,12327,288,
rw,23,41,391,2,992,11335,994,
goni,23,41,371,22,358,11969,380,
kenett,23,41,256,137,218,12109,355,
fe,23,41,106,287,0,12327,287,
rw,23,42,391,2,1014,11313,1016,
goni,23,42,372,21,359,11968,380,
kenett,23,42,253,140,221,12106,361,
fe,23,42,109,284,0,12327,284,
rw,23,43,391,2,1031,11296,1033,
goni,23,43,374,19,377,11950,396,
kenett,23,43,258,135,216,12111,351,
fe,23,43,110,283,0,12327,283,
rw,23,44,391,2,1044,11283,1046,
goni,23,44,375,18,380,11947,398,
kenett,23,44,266,127,208,12119,335,
fe,23,44,113,280,0,12327,280,
rw,23,45,391,2,1059,11268,1061,
goni,23,45,377,16,379,11948,395,
kenett,23,45,266,127,208,12119,335,
fe,23,45,115,278,0,12327,278,
rw,23,46,392,1,1069,11258,1070,
goni,23,46,377,16,385,11942,401,
kenett,23,46,267,126,207,12120,333,
fe,23,46,118,275,0,12327,275,
rw,23,47,392,1,1092,11235,1093,
goni,23,47,378,15,390,11937,405,
kenett,23,47,270,123,204,12123,327,
fe,23,47,119,274,0,12327,274,
rw,23,48,392,1,1110,11217,1111,
goni,23,48,381,12,398,11929,410,
kenett,23,48,267,126,207,12120,333,
fe,23,48,120,273,0,12327,273,
rw,23,49,392,1,1125,11202,1126,
goni,23,49,384,9,399,11928,408,
kenett,23,49,270,123,204,12123,327,
fe,23,49,123,270,0,12327,270,
rw,23,50,392,1,1140,11187,1141,
goni,23,50,384,9,406,11921,415,
kenett,23,50,272,121,202,12125,323,
fe,23,50,125,268,0,12327,268,
rw,24,1,69,324,25,12302,349,
goni,24,1,12,381,1,12326,382,
kenett,24,1,13,380,224,12103,604,
fe,24,1,3,390,0,12327,390,
rw,24,2,125,268,54,12273,322,
goni,24,2,35,358,7,12320,365,
kenett,24,2,12,381,339,11988,720,
fe,24,2,6,387,0,12327,387,
rw,24,3,165,228,81,12246,309,
goni,24,3,59,334,13,12314,347,
kenett,24,3,16,377,380,11947,757,
fe,24,3,9,384,0,12327,384,
rw,24,4,201,192,113,12214,305,
goni,24,4,90,303,23,12304,326,
kenett,24,4,18,375,387,11940,762,
fe,24,4,12,381,0,12327,381,
rw,24,5,236,157,137,12190,294,
goni,24,5,120,273,30,12297,303,
kenett,24,5,17,376,418,11909,794,
fe,24,5,15,378,0,12327,378,
rw,24,6,262,131,162,12165,293,
goni,24,6,149,244,40,12287,284,
kenett,24,6,17,376,427,11900,803,
fe,24,6,17,376,0,12327,376,
rw,24,7,285,108,193,12134,301,
goni,24,7,180,213,54,12273,267,
kenett,24,7,18,375,444,11883,819,
fe,24,7,20,373,0,12327,373,
rw,24,8,301,92,220,12107,312,
goni,24,8,198,195,66,12261,261,
kenett,24,8,25,368,443,11884,811,
fe,24,8,23,370,0,12327,370,
rw,24,9,315,78,255,12072,333,
goni,24,9,218,175,85,12242,260,
kenett,24,9,28,365,440,11887,805,
fe,24,9,25,368,0,12327,368,
rw,24,10,327,66,281,12046,347,
goni,24,10,235,158,104,12223,262,
kenett,24,10,38,355,433,11894,788,
fe,24,10,28,365,0,12327,365,
rw,24,11,334,59,302,12025,361,
goni,24,11,253,140,113,12214,253,
kenett,24,11,44,349,427,11900,776,
fe,24,11,31,362,0,12327,362,
rw,24,12,347,46,329,11998,375,
goni,24,12,261,132,122,12205,254,
kenett,24,12,46,347,425,11902,772,
fe,24,12,34,359,0,12327,359,
rw,24,13,354,39,356,11971,395,
goni,24,13,271,122,124,12203,246,
kenett,24,13,32,361,439,11888,800,
fe,24,13,37,356,0,12327,356,
rw,24,14,356,37,376,11951,413,
goni,24,14,282,111,139,12188,250,
kenett,24,14,49,344,422,11905,766,
fe,24,14,39,354,0,12327,354,
rw,24,15,368,25,396,11931,421,
goni,24,15,288,105,143,12184,248,
kenett,24,15,33,360,438,11889,798,
fe,24,15,42,351,0,12327,351,
rw,24,16,370,23,418,11909,441,
goni,24,16,292,101,165,12162,266,
kenett,24,16,44,349,427,11900,776,
fe,24,16,45,348,0,12327,348,
rw,24,17,372,21,443,11884,464,
goni,24,17,300,93,182,12145,275,
kenett,24,17,44,349,427,11900,776,
fe,24,17,48,345,0,12327,345,
rw,24,18,372,21,465,11862,486,
goni,24,18,309,84,187,12140,271,
kenett,24,18,47,346,424,11903,770,
fe,24,18,50,343,0,12327,343,
rw,24,19,376,17,488,11839,505,
goni,24,19,322,71,198,12129,269,
kenett,24,19,44,349,427,11900,776,
fe,24,19,53,340,0,12327,340,
rw,24,20,381,12,506,11821,518,
goni,24,20,328,65,195,12132,260,
kenett,24,20,240,153,234,12093,387,
fe,24,20,56,337,0,12327,337,
rw,24,21,382,11,526,11801,537,
goni,24,21,327,66,209,12118,275,
kenett,24,21,237,156,237,12090,393,
fe,24,21,58,335,0,12327,335,
rw,24,22,384,9,558,11769,567,
goni,24,22,330,63,215,12112,278,
kenett,24,22,247,146,227,12100,373,
fe,24,22,60,333,0,12327,333,
rw,24,23,384,9,579,11748,588,
goni,24,23,333,60,225,12102,285,
kenett,24,23,248,145,226,12101,371,
fe,24,23,63,330,0,12327,330,
rw,24,24,385,8,599,11728,607,
goni,24,24,341,52,243,12084,295,
kenett,24,24,247,146,227,12100,373,
fe,24,24,64,329,0,12327,329,
rw,24,25,386,7,623,11704,630,
goni,24,25,346,47,248,12079,295,
kenett,24,25,258,135,216,12111,351,
fe,24,25,67,326,0,12327,326,
rw,24,26,388,5,642,11685,647,
goni,24,26,349,44,251,12076,295,
kenett,24,26,253,140,221,12106,361,
fe,24,26,68,325,0,12327,325,
rw,24,27,389,4,668,11659,672,
goni,24,27,350,43,257,12070,300,
kenett,24,27,255,138,219,12108,357,
fe,24,27,70,323,0,12327,323,
rw,24,28,390,3,696,11631,699,
goni,24,28,355,38,271,12056,309,
kenett,24,28,250,143,224,12103,367,
fe,24,28,70,323,0,12327,323,
rw,24,29,391,2,713,11614,715,
goni,24,29,360,33,277,12050,310,
kenett,24,29,259,134,215,12112,349,
fe,24,29,73,320,0,12327,320,
rw,24,30,392,1,733,11594,734,
goni,24,30,358,35,276,12051,311,
kenett,24,30,252,141,222,12105,363,
fe,24,30,75,318,0,12327,318,
rw,24,31,392,1,749,11578,750,
goni,24,31,360,33,289,12038,322,
kenett,24,31,257,136,217,12110,353,
fe,24,31,77,316,0,12327,316,
rw,24,32,392,1,773,11554,774,
goni,24,32,362,31,298,12029,329,
kenett,24,32,260,133,214,12113,347,
fe,24,32,79,314,0,12327,314,
rw,24,33,392,1,791,11536,792,
goni,24,33,363,30,300,12027,330,
kenett,24,33,258,135,216,12111,351,
fe,24,33,80,313,0,12327,313,
rw,24,34,392,1,815,11512,816,
goni,24,34,364,29,306,12021,335,
kenett,24,34,262,131,212,12115,343,
fe,24,34,82,311,0,12327,311,
rw,24,35,392,1,833,11494,834,
goni,24,35,364,29,317,12010,346,
kenett,24,35,265,128,209,12118,337,
fe,24,35,85,308,0,12327,308,
rw,24,36,392,1,845,11482,846,
goni,24,36,367,26,324,12003,350,
kenett,24,36,269,124,205,12122,329,
fe,24,36,88,305,0,12327,305,
rw,24,37,392,1,859,11468,860,
goni,24,37,368,25,326,12001,351,
kenett,24,37,267,126,207,12120,333,
fe,24,37,91,302,0,12327,302,
rw,24,38,392,1,876,11451,877,
goni,24,38,369,24,335,11992,359,
kenett,24,38,267,126,207,12120,333,
fe,24,38,93,300,0,12327,300,
rw,24,39,392,1,891,11436,892,
goni,24,39,369,24,336,11991,360,
kenett,24,39,269,124,205,12122,329,
fe,24,39,94,299,0,12327,299,
rw,24,40,392,1,908,11419,909,
goni,24,40,374,19,342,11985,361,
kenett,24,40,276,117,198,12129,315,
fe,24,40,95,298,0,12327,298,
rw,24,41,392,1,930,11397,931,
goni,24,41,376,17,346,11981,363,
kenett,24,41,272,121,202,12125,323,
fe,24,41,97,296,0,12327,296,
rw,24,42,392,1,950,11377,951,
goni,24,42,375,18,358,11969,376,
kenett,24,42,270,123,204,12123,327,
fe,24,42,98,295,0,12327,295,
rw,24,43,392,1,966,11361,967,
goni,24,43,376,17,359,11968,376,
kenett,24,43,271,122,203,12124,325,
fe,24,43,101,292,0,12327,292,
rw,24,44,392,1,982,11345,983,
goni,24,44,374,19,363,11964,382,
kenett,24,44,269,124,205,12122,329,
fe,24,44,104,289,0,12327,289,
rw,24,45,392,1,993,11334,994,
goni,24,45,377,16,372,11955,388,
kenett,24,45,270,123,204,12123,327,
fe,24,45,107,286,0,12327,286,
rw,24,46,392,1,1011,11316,1012,
goni,24,46,377,16,373,11954,389,
kenett,24,46,268,125,206,12121,331,
fe,24,46,110,283,0,12327,283,
rw,24,47,392,1,1025,11302,1026,
goni,24,47,378,15,383,11944,398,
kenett,24,47,268,125,206,12121,331,
fe,24,47,112,281,0,12327,281,
rw,24,48,392,1,1039,11288,1040,
goni,24,48,379,14,395,11932,409,
kenett,24,48,272,121,202,12125,323,
fe,24,48,114,279,0,12327,279,
rw,24,49,392,1,1053,11274,1054,
goni,24,49,379,14,410,11917,424,
kenett,24,49,272,121,202,12125,323,
fe,24,49,116,277,0,12327,277,
rw,24,50,392,1,1073,11254,1074,
goni,24,50,381,12,418,11909,430,
kenett,24,50,274,119,200,12127,319,
fe,24,50,118,275,0,12327,275,
rw,25,1,73,320,25,12302,345,
goni,25,1,6,387,0,12327,387,
kenett,25,1,10,383,230,12097,613,
fe,25,1,3,390,0,12327,390,
rw,25,2,139,254,43,12284,297,
goni,25,2,35,358,3,12324,361,
kenett,25,2,22,371,296,12031,667,
fe,25,2,6,387,0,12327,387,
rw,25,3,185,208,74,12253,282,
goni,25,3,66,327,13,12314,340,
kenett,25,3,19,374,347,11980,721,
fe,25,3,9,384,0,12327,384,
rw,25,4,220,173,107,12220,280,
goni,25,4,88,305,20,12307,325,
kenett,25,4,20,373,394,11933,767,
fe,25,4,12,381,0,12327,381,
rw,25,5,250,143,135,12192,278,
goni,25,5,116,277,24,12303,301,
kenett,25,5,21,372,408,11919,780,
fe,25,5,15,378,0,12327,378,
rw,25,6,277,116,164,12163,280,
goni,25,6,141,252,38,12289,290,
kenett,25,6,19,374,425,11902,799,
fe,25,6,17,376,0,12327,376,
rw,25,7,290,103,195,12132,298,
goni,25,7,160,233,43,12284,276,
kenett,25,7,21,372,426,11901,798,
fe,25,7,19,374,0,12327,374,
rw,25,8,312,81,226,12101,307,
goni,25,8,191,202,62,12265,264,
kenett,25,8,21,372,435,11892,807,
fe,25,8,22,371,0,12327,371,
rw,25,9,324,69,257,12070,326,
goni,25,9,206,187,72,12255,259,
kenett,25,9,25,368,434,11893,802,
fe,25,9,25,368,0,12327,368,
rw,25,10,330,63,288,12039,351,
goni,25,10,216,177,84,12243,261,
kenett,25,10,21,372,444,11883,816,
fe,25,10,28,365,0,12327,365,
rw,25,11,335,58,323,12004,381,
goni,25,11,225,168,92,12235,260,
kenett,25,11,34,359,437,11890,796,
fe,25,11,30,363,0,12327,363,
rw,25,12,344,49,344,11983,393,
goni,25,12,248,145,112,12215,257,
kenett,25,12,35,358,436,11891,794,
fe,25,12,33,360,0,12327,360,
rw,25,13,347,46,375,11952,421,
goni,25,13,255,138,123,12204,261,
kenett,25,13,190,203,284,12043,487,
fe,25,13,36,357,0,12327,357,
rw,25,14,352,41,401,11926,442,
goni,25,14,273,120,136,12191,256,
kenett,25,14,192,201,282,12045,483,
fe,25,14,38,355,0,12327,355,
rw,25,15,357,36,426,11901,462,
goni,25,15,279,114,149,12178,263,
kenett,25,15,191,202,283,12044,485,
fe,25,15,40,353,0,12327,353,
rw,25,16,360,33,462,11865,495,
goni,25,16,285,108,160,12167,268,
kenett,25,16,202,191,272,12055,463,
fe,25,16,42,351,0,12327,351,
rw,25,17,363,30,483,11844,513,
goni,25,17,296,97,173,12154,270,
kenett,25,17,206,187,268,12059,455,
fe,25,17,45,348,0,12327,348,
rw,25,18,370,23,507,11820,530,
goni,25,18,299,94,184,12143,278,
kenett,25,18,219,174,255,12072,429,
fe,25,18,47,346,0,12327,346,
rw,25,19,373,20,534,11793,554,
goni,25,19,309,84,191,12136,275,
kenett,25,19,224,169,250,12077,419,
fe,25,19,49,344,0,12327,344,
rw,25,20,374,19,558,11769,577,
goni,25,20,320,73,206,12121,279,
kenett,25,20,220,173,254,12073,427,
fe,25,20,52,341,0,12327,341,
rw,25,21,377,16,577,11750,593,
goni,25,21,325,68,218,12109,286,
kenett,25,21,229,164,245,12082,409,
fe,25,21,55,338,0,12327,338,
rw,25,22,377,16,602,11725,618,
goni,25,22,326,67,217,12110,284,
kenett,25,22,229,164,245,12082,409,
fe,25,22,57,336,0,12327,336,
rw,25,23,379,14,622,11705,636,
goni,25,23,330,63,221,12106,284,
kenett,25,23,241,152,233,12094,385,
fe,25,23,59,334,0,12327,334,
rw,25,24,380,13,648,11679,661,
goni,25,24,339,54,217,12110,271,
kenett,25,24,240,153,234,12093,387,
fe,25,24,61,332,0,12327,332,
rw,25,25,381,12,670,11657,682,
goni,25,25,345,48,231,12096,279,
kenett,25,25,238,155,236,12091,391,
fe,25,25,64,329,0,12327,329,
rw,25,26,384,9,695,11632,704,
goni,25,26,346,47,246,12081,293,
kenett,25,26,237,156,237,12090,393,
fe,25,26,66,327,0,12327,327,
rw,25,27,385,8,716,11611,724,
goni,25,27,347,46,253,12074,299,
kenett,25,27,241,152,233,12094,385,
fe,25,27,68,325,0,12327,325,
rw,25,28,386,7,731,11596,738,
goni,25,28,351,42,259,12068,301,
kenett,25,28,253,140,221,12106,361,
fe,25,28,70,323,0,12327,323,
rw,25,29,386,7,753,11574,760,
goni,25,29,353,40,272,12055,312,
kenett,25,29,243,150,231,12096,381,
fe,25,29,71,322,0,12327,322,
rw,25,30,386,7,773,11554,780,
goni,25,30,352,41,279,12048,320,
kenett,25,30,253,140,221,12106,361,
fe,25,30,74,319,0,12327,319,
rw,25,31,387,6,793,11534,799,
goni,25,31,355,38,276,12051,314,
kenett,25,31,254,139,220,12107,359,
fe,25,31,77,316,0,12327,316,
rw,25,32,388,5,816,11511,821,
goni,25,32,360,33,284,12043,317,
kenett,25,32,254,139,220,12107,359,
fe,25,32,79,314,0,12327,314,
rw,25,33,388,5,838,11489,843,
goni,25,33,361,32,297,12030,329,
kenett,25,33,259,134,215,12112,349,
fe,25,33,81,312,0,12327,312,
rw,25,34,389,4,858,11469,862,
goni,25,34,360,33,309,12018,342,
kenett,25,34,258,135,216,12111,351,
fe,25,34,83,310,0,12327,310,
rw,25,35,390,3,882,11445,885,
goni,25,35,360,33,312,12015,345,
kenett,25,35,270,123,204,12123,327,
fe,25,35,86,307,0,12327,307,
rw,25,36,390,3,901,11426,904,
goni,25,36,362,31,320,12007,351,
kenett,25,36,265,128,209,12118,337,
fe,25,36,88,305,0,12327,305,
rw,25,37,390,3,917,11410,920,
goni,25,37,363,30,325,12002,355,
kenett,25,37,269,124,205,12122,329,
fe,25,37,90,303,0,12327,303,
rw,25,38,391,2,935,11392,937,
goni,25,38,365,28,326,12001,354,
kenett,25,38,261,132,213,12114,345,
fe,25,38,93,300,0,12327,300,
rw,25,39,392,1,952,11375,953,
goni,25,39,365,28,331,11996,359,
kenett,25,39,259,134,215,12112,349,
fe,25,39,96,297,0,12327,297,
rw,25,40,392,1,964,11363,965,
goni,25,40,369,24,341,11986,365,
kenett,25,40,264,129,210,12117,339,
fe,25,40,99,294,0,12327,294,
rw,25,41,392,1,983,11344,984,
goni,25,41,370,23,346,11981,369,
kenett,25,41,262,131,212,12115,343,
fe,25,41,101,292,0,12327,292,
rw,25,42,392,1,996,11331,997,
goni,25,42,370,23,353,11974,376,
kenett,25,42,272,121,202,12125,323,
fe,25,42,103,290,0,12327,290,
rw,25,43,392,1,1015,11312,1016,
goni,25,43,370,23,354,11973,377,
kenett,25,43,271,122,203,12124,325,
fe,25,43,104,289,0,12327,289,
rw,25,44,393,0,1032,11295,1032,
goni,25,44,373,20,367,11960,387,
kenett,25,44,274,119,200,12127,319,
fe,25,44,107,286,0,12327,286,
rw,25,45,393,0,1047,11280,1047,
goni,25,45,375,18,372,11955,390,
kenett,25,45,275,118,199,12128,317,
fe,25,45,110,283,0,12327,283,
rw,25,46,393,0,1060,11267,1060,
goni,25,46,376,17,376,11951,393,
kenett,25,46,267,126,207,12120,333,
fe,25,46,111,282,0,12327,282,
rw,25,47,393,0,1076,11251,1076,
goni,25,47,375,18,376,11951,394,
kenett,25,47,267,126,207,12120,333,
fe,25,47,113,280,0,12327,280,
rw,25,48,393,0,1096,11231,1096,
goni,25,48,376,17,379,11948,396,
kenett,25,48,265,128,209,12118,337,
fe,25,48,115,278,0,12327,278,
rw,25,49,393,0,1113,11214,1113,
goni,25,49,376,17,383,11944,400,
kenett,25,49,269,124,205,12122,329,
fe,25,49,118,275,0,12327,275,
rw,25,50,393,0,1124,11203,1124,
goni,25,50,374,19,394,11933,413,
kenett,25,50,268,125,206,12121,331,
fe,25,50,120,273,0,12327,273,
rw,26,1,59,334,40,12287,374,
goni,26,1,6,387,1,12326,388,
kenett,26,1,7,386,236,12091,622,
fe,26,1,3,390,0,12327,390,
rw,26,2,114,279,68,12259,347,
goni,26,2,33,360,8,12319,368,
kenett,26,2,11,382,307,12020,689,
fe,26,2,6,387,0,12327,387,
rw,26,3,154,239,105,12222,344,
goni,26,3,55,338,19,12308,357,
kenett,26,3,14,379,361,11966,740,
fe,26,3,9,384,0,12327,384,
rw,26,4,201,192,131,12196,323,
goni,26,4,82,311,32,12295,343,
kenett,26,4,16,377,383,11944,760,
fe,26,4,12,381,0,12327,381,
rw,26,5,234,159,164,12163,323,
goni,26,5,110,283,41,12286,324,
kenett,26,5,17,376,418,11909,794,
fe,26,5,15,378,0,12327,378,
rw,26,6,261,132,198,12129,330,
goni,26,6,130,263,46,12281,309,
kenett,26,6,15,378,444,11883,822,
fe,26,6,18,375,0,12327,375,
rw,26,7,286,107,221,12106,328,
goni,26,7,157,236,67,12260,303,
kenett,26,7,17,376,445,11882,821,
fe,26,7,21,372,0,12327,372,
rw,26,8,306,87,243,12084,330,
goni,26,8,187,206,85,12242,291,
kenett,26,8,12,381,450,11877,831,
fe,26,8,24,369,0,12327,369,
rw,26,9,314,79,266,12061,345,
goni,26,9,212,181,94,12233,275,
kenett,26,9,11,382,451,11876,833,
fe,26,9,27,366,0,12327,366,
rw,26,10,323,70,296,12031,366,
goni,26,10,224,169,115,12212,284,
kenett,26,10,20,373,445,11882,818,
fe,26,10,30,363,0,12327,363,
rw,26,11,332,61,329,11998,390,
goni,26,11,241,152,131,12196,283,
kenett,26,11,37,356,434,11893,790,
fe,26,11,33,360,0,12327,360,
rw,26,12,344,49,351,11976,400,
goni,26,12,251,142,145,12182,287,
kenett,26,12,41,352,430,11897,782,
fe,26,12,36,357,0,12327,357,
rw,26,13,349,44,373,11954,417,
goni,26,13,266,127,153,12174,280,
kenett,26,13,47,346,424,11903,770,
fe,26,13,39,354,0,12327,354,
rw,26,14,355,38,400,11927,438,
goni,26,14,272,121,161,12166,282,
kenett,26,14,39,354,432,11895,786,
fe,26,14,42,351,0,12327,351,
rw,26,15,356,37,427,11900,464,
goni,26,15,278,115,168,12159,283,
kenett,26,15,35,358,436,11891,794,
fe,26,15,45,348,0,12327,348,
rw,26,16,366,27,461,11866,488,
goni,26,16,283,110,175,12152,285,
kenett,26,16,205,188,269,12058,457,
fe,26,16,48,345,0,12327,345,
rw,26,17,370,23,490,11837,513,
goni,26,17,292,101,190,12137,291,
kenett,26,17,225,168,249,12078,417,
fe,26,17,50,343,0,12327,343,
rw,26,18,372,21,506,11821,527,
goni,26,18,301,92,199,12128,291,
kenett,26,18,228,165,246,12081,411,
fe,26,18,53,340,0,12327,340,
rw,26,19,374,19,524,11803,543,
goni,26,19,310,83,214,12113,297,
kenett,26,19,227,166,247,12080,413,
fe,26,19,56,337,0,12327,337,
rw,26,20,378,15,547,11780,562,
goni,26,20,318,75,218,12109,293,
kenett,26,20,232,161,242,12085,403,
fe,26,20,59,334,0,12327,334,
rw,26,21,378,15,573,11754,588,
goni,26,21,326,67,233,12094,300,
kenett,26,21,221,172,253,12074,425,
fe,26,21,61,332,0,12327,332,
rw,26,22,381,12,593,11734,605,
goni,26,22,338,55,241,12086,296,
kenett,26,22,222,171,252,12075,423,
fe,26,22,64,329,0,12327,329,
rw,26,23,382,11,612,11715,623,
goni,26,23,341,52,250,12077,302,
kenett,26,23,226,167,248,12079,415,
fe,26,23,66,327,0,12327,327,
rw,26,24,384,9,632,11695,641,
goni,26,24,343,50,255,12072,305,
kenett,26,24,241,152,233,12094,385,
fe,26,24,68,325,0,12327,325,
rw,26,25,385,8,645,11682,653,
goni,26,25,347,46,258,12069,304,
kenett,26,25,238,155,236,12091,391,
fe,26,25,71,322,0,12327,322,
rw,26,26,385,8,668,11659,676,
goni,26,26,350,43,267,12060,310,
kenett,26,26,236,157,238,12089,395,
fe,26,26,74,319,0,12327,319,
rw,26,27,386,7,693,11634,700,
goni,26,27,353,40,272,12055,312,
kenett,26,27,243,150,231,12096,381,
fe,26,27,77,316,0,12327,316,
rw,26,28,386,7,711,11616,718,
goni,26,28,355,38,287,12040,325,
kenett,26,28,249,144,225,12102,369,
fe,26,28,80,313,0,12327,313,
rw,26,29,387,6,728,11599,734,
goni,26,29,355,38,296,12031,334,
kenett,26,29,252,141,222,12105,363,
fe,26,29,82,311,0,12327,311,
rw,26,30,389,4,743,11584,747,
goni,26,30,358,35,302,12025,337,
kenett,26,30,255,138,219,12108,357,
fe,26,30,83,310,0,12327,310,
rw,26,31,390,3,766,11561,769,
goni,26,31,359,34,314,12013,348,
kenett,26,31,254,139,220,12107,359,
fe,26,31,86,307,0,12327,307,
rw,26,32,390,3,787,11540,790,
goni,26,32,360,33,322,12005,355,
kenett,26,32,261,132,213,12114,345,
fe,26,32,88,305,0,12327,305,
rw,26,33,390,3,807,11520,810,
goni,26,33,362,31,329,11998,360,
kenett,26,33,253,140,221,12106,361,
fe,26,33,89,304,0,12327,304,
rw,26,34,390,3,823,11504,826,
goni,26,34,368,25,325,12002,350,
kenett,26,34,255,138,219,12108,357,
fe,26,34,92,301,0,12327,301,
rw,26,35,390,3,839,11488,842,
goni,26,35,370,23,341,11986,364,
kenett,26,35,254,139,220,12107,359,
fe,26,35,94,299,0,12327,299,
rw,26,36,390,3,858,11469,861,
goni,26,36,373,20,346,11981,366,
kenett,26,36,258,135,216,12111,351,
fe,26,36,95,298,0,12327,298,
rw,26,37,390,3,883,11444,886,
goni,26,37,374,19,345,11982,364,
kenett,26,37,263,130,211,12116,341,
fe,26,37,97,296,0,12327,296,
rw,26,38,390,3,904,11423,907,
goni,26,38,374,19,355,11972,374,
kenett,26,38,262,131,212,12115,343,
fe,26,38,98,295,0,12327,295,
rw,26,39,391,2,921,11406,923,
goni,26,39,375,18,367,11960,385,
kenett,26,39,265,128,209,12118,337,
fe,26,39,100,293,0,12327,293,
rw,26,40,391,2,944,11383,946,
goni,26,40,377,16,372,11955,388,
kenett,26,40,263,130,211,12116,341,
fe,26,40,102,291,0,12327,291,
rw,26,41,391,2,958,11369,960,
goni,26,41,375,18,381,11946,399,
kenett,26,41,265,128,209,12118,337,
fe,26,41,105,288,0,12327,288,
rw,26,42,391,2,972,11355,974,
goni,26,42,376,17,385,11942,402,
kenett,26,42,264,129,210,12117,339,
fe,26,42,108,285,0,12327,285,
rw,26,43,391,2,995,11332,997,
goni,26,43,378,15,391,11936,406,
kenett,26,43,260,133,214,12113,347,
fe,26,43,110,283,0,12327,283,
rw,26,44,391,2,1010,11317,1012,
goni,26,44,381,12,399,11928,411,
kenett,26,44,265,128,209,12118,337,
fe,26,44,113,280,0,12327,280,
rw,26,45,391,2,1030,11297,1032,
goni,26,45,380,13,405,11922,418,
kenett,26,45,264,129,210,12117,339,
fe,26,45,115,278,0,12327,278,
rw,26,46,391,2,1047,11280,1049,
goni,26,46,384,9,411,11916,420,
kenett,26,46,267,126,207,12120,333,
fe,26,46,117,276,0,12327,276,
rw,26,47,391,2,1065,11262,1067,
goni,26,47,384,9,422,11905,431,
kenett,26,47,270,123,204,12123,327,
fe,26,47,118,275,0,12327,275,
rw,26,48,392,1,1079,11248,1080,
goni,26,48,384,9,427,11900,436,
kenett,26,48,269,124,205,12122,329,
fe,26,48,120,273,0,12327,273,
rw,26,49,392,1,1096,11231,1097,
goni,26,49,384,9,438,11889,447,
kenett,26,49,268,125,206,12121,331,
fe,26,49,122,271,0,12327,271,
rw,26,50,392,1,1109,11218,1110,
goni,26,50,387,6,444,11883,450,
kenett,26,50,269,124,205,12122,329,
fe,26,50,123,270,0,12327,270,
rw,27,1,65,328,31,12296,359,
goni,27,1,9,384,1,12326,385,
kenett,27,1,13,380,185,12142,565,
fe,27,1,3,390,0,12327,390,
rw,27,2,115,278,66,12261,344,
goni,27,2,30,363,7,12320,370,
kenett,27,2,16,377,299,12028,676,
fe,27,2,6,387,0,12327,387,
rw,27,3,162,231,96,12231,327,
goni,27,3,60,333,14,12313,347,
kenett,27,3,16,377,368,11959,745,
fe,27,3,9,384,0,12327,384,
rw,27,4,195,198,127,12200,325,
goni,27,4,75,318,22,12305,340,
kenett,27,4,19,374,419,11908,793,
fe,27,4,12,381,0,12327,381,
rw,27,5,222,171,166,12161,337,
goni,27,5,103,290,33,12294,323,
kenett,27,5,16,377,437,11890,814,
fe,27,5,13,380,0,12327,380,
rw,27,6,251,142,191,12136,333,
goni,27,6,132,261,43,12284,304,
kenett,27,6,20,373,439,11888,812,
fe,27,6,16,377,0,12327,377,
rw,27,7,270,123,220,12107,343,
goni,27,7,153,240,53,12274,293,
kenett,27,7,16,377,446,11881,823,
fe,27,7,19,374,0,12327,374,
rw,27,8,287,106,249,12078,355,
goni,27,8,170,223,58,12269,281,
kenett,27,8,24,369,441,11886,810,
fe,27,8,22,371,0,12327,371,
rw,27,9,304,89,274,12053,363,
goni,27,9,187,206,66,12261,272,
kenett,27,9,15,378,450,11877,828,
fe,27,9,25,368,0,12327,368,
rw,27,10,315,78,304,12023,382,
goni,27,10,207,186,79,12248,265,
kenett,27,10,27,366,441,11886,807,
fe,27,10,28,365,0,12327,365,
rw,27,11,322,71,329,11998,400,
goni,27,11,221,172,97,12230,269,
kenett,27,11,20,373,448,11879,821,
fe,27,11,31,362,0,12327,362,
rw,27,12,333,60,355,11972,415,
goni,27,12,243,150,102,12225,252,
kenett,27,12,37,356,434,11893,790,
fe,27,12,33,360,0,12327,360,
rw,27,13,342,51,386,11941,437,
goni,27,13,252,141,116,12211,257,
kenett,27,13,36,357,435,11892,792,
fe,27,13,36,357,0,12327,357,
rw,27,14,353,40,406,11921,446,
goni,27,14,272,121,124,12203,245,
kenett,27,14,36,357,435,11892,792,
fe,27,14,38,355,0,12327,355,
rw,27,15,356,37,428,11899,465,
goni,27,15,273,120,139,12188,259,
kenett,27,15,35,358,436,11891,794,
fe,27,15,41,352,0,12327,352,
rw,27,16,359,34,449,11878,483,
goni,27,16,279,114,154,12173,268,
kenett,27,16,40,353,431,11896,784,
fe,27,16,43,350,0,12327,350,
rw,27,17,364,29,472,11855,501,
goni,27,17,289,104,172,12155,276,
kenett,27,17,42,351,429,11898,780,
fe,27,17,45,348,0,12327,348,
rw,27,18,368,25,490,11837,515,
goni,27,18,294,99,174,12153,273,
kenett,27,18,49,344,422,11905,766,
fe,27,18,48,345,0,12327,345,
rw,27,19,373,20,514,11813,534,
goni,27,19,305,88,186,12141,274,
kenett,27,19,218,175,256,12071,431,
fe,27,19,51,342,0,12327,342,
rw,27,20,376,17,537,11790,554,
goni,27,20,309,84,194,12133,278,
kenett,27,20,220,173,254,12073,427,
fe,27,20,53,340,0,12327,340,
rw,27,21,380,13,558,11769,571,
goni,27,21,315,78,210,12117,288,
kenett,27,21,236,157,238,12089,395,
fe,27,21,56,337,0,12327,337,
rw,27,22,381,12,587,11740,599,
goni,27,22,317,76,218,12109,294,
kenett,27,22,233,160,241,12086,401,
fe,27,22,59,334,0,12327,334,
rw,27,23,381,12,604,11723,616,
goni,27,23,320,73,228,12099,301,
kenett,27,23,235,158,239,12088,397,
fe,27,23,61,332,0,12327,332,
rw,27,24,382,11,631,11696,642,
goni,27,24,325,68,234,12093,302,
kenett,27,24,229,164,245,12082,409,
fe,27,24,63,330,0,12327,330,
rw,27,25,384,9,650,11677,659,
goni,27,25,330,63,246,12081,309,
kenett,27,25,235,158,239,12088,397,
fe,27,25,64,329,0,12327,329,
rw,27,26,386,7,668,11659,675,
goni,27,26,337,56,255,12072,311,
kenett,27,26,239,154,235,12092,389,
fe,27,26,67,326,0,12327,326,
rw,27,27,387,6,691,11636,697,
goni,27,27,341,52,259,12068,311,
kenett,27,27,237,156,237,12090,393,
fe,27,27,69,324,0,12327,324,
rw,27,28,390,3,711,11616,714,
goni,27,28,348,45,270,12057,315,
kenett,27,28,237,156,237,12090,393,
fe,27,28,72,321,0,12327,321,
rw,27,29,391,2,731,11596,733,
goni,27,29,352,41,285,12042,326,
kenett,27,29,243,150,231,12096,381,
fe,27,29,73,320,0,12327,320,
rw,27,30,391,2,751,11576,753,
goni,27,30,358,35,293,12034,328,
kenett,27,30,245,148,229,12098,377,
fe,27,30,76,317,0,12327,317,
rw,27,31,392,1,768,11559,769,
goni,27,31,358,35,297,12030,332,
kenett,27,31,247,146,227,12100,373,
fe,27,31,77,316,0,12327,316,
rw,27,32,392,1,785,11542,786,
goni,27,32,360,33,297,12030,330,
kenett,27,32,252,141,222,12105,363,
fe,27,32,79,314,0,12327,314,
rw,27,33,392,1,805,11522,806,
goni,27,33,362,31,305,12022,336,
kenett,27,33,251,142,223,12104,365,
fe,27,33,82,311,0,12327,311,
rw,27,34,392,1,828,11499,829,
goni,27,34,364,29,310,12017,339,
kenett,27,34,250,143,224,12103,367,
fe,27,34,85,308,0,12327,308,
rw,27,35,392,1,851,11476,852,
goni,27,35,366,27,321,12006,348,
kenett,27,35,250,143,224,12103,367,
fe,27,35,88,305,0,12327,305,
rw,27,36,392,1,860,11467,861,
goni,27,36,367,26,325,12002,351,
kenett,27,36,252,141,222,12105,363,
fe,27,36,90,303,0,12327,303,
rw,27,37,392,1,874,11453,875,
goni,27,37,367,26,330,11997,356,
kenett,27,37,254,139,220,12107,359,
fe,27,37,92,301,0,12327,301,
rw,27,38,392,1,894,11433,895,
goni,27,38,367,26,336,11991,362,
kenett,27,38,257,136,217,12110,353,
fe,27,38,94,299,0,12327,299,
rw,27,39,392,1,915,11412,916,
goni,27,39,368,25,336,11991,361,
kenett,27,39,260,133,214,12113,347,
fe,27,39,96,297,0,12327,297,
rw,27,40,393,0,935,11392,935,
goni,27,40,371,22,342,11985,364,
kenett,27,40,266,127,208,12119,335,
fe,27,40,97,296,0,12327,296,
rw,27,41,393,0,951,11376,951,
goni,27,41,374,19,343,11984,362,
kenett,27,41,263,130,211,12116,341,
fe,27,41,99,294,0,12327,294,
rw,27,42,393,0,969,11358,969,
goni,27,42,374,19,347,11980,366,
kenett,27,42,264,129,210,12117,339,
fe,27,42,101,292,0,12327,292,
rw,27,43,393,0,988,11339,988,
goni,27,43,374,19,353,11974,372,
kenett,27,43,267,126,207,12120,333,
fe,27,43,104,289,0,12327,289,
rw,27,44,393,0,1009,11318,1009,
goni,27,44,376,17,353,11974,370,
kenett,27,44,264,129,210,12117,339,
fe,27,44,106,287,0,12327,287,
rw,27,45,393,0,1024,11303,1024,
goni,27,45,375,18,358,11969,376,
kenett,27,45,267,126,207,12120,333,
fe,27,45,108,285,0,12327,285,
rw,27,46,393,0,1043,11284,1043,
goni,27,46,377,16,367,11960,383,
kenett,27,46,267,126,207,12120,333,
fe,27,46,110,283,0,12327,283,
rw,27,47,393,0,1056,11271,1056,
goni,27,47,377,16,371,11956,387,
kenett,27,47,265,128,209,12118,337,
fe,27,47,111,282,0,12327,282,
rw,27,48,393,0,1075,11252,1075,
goni,27,48,377,16,380,11947,396,
kenett,27,48,268,125,206,12121,331,
fe,27,48,114,279,0,12327,279,
rw,27,49,393,0,1092,11235,1092,
goni,27,49,377,16,382,11945,398,
kenett,27,49,270,123,204,12123,327,
fe,27,49,116,277,0,12327,277,
rw,27,50,393,0,1108,11219,1108,
goni,27,50,377,16,398,11929,414,
kenett,27,50,273,120,201,12126,321,
fe,27,50,119,274,0,12327,274,
rw,28,1,72,321,27,12300,348,
goni,28,1,8,385,2,12325,387,
kenett,28,1,14,379,208,12119,587,
fe,28,1,3,390,0,12327,390,
rw,28,2,133,260,46,12281,306,
goni,28,2,30,363,3,12324,366,
kenett,28,2,18,375,288,12039,663,
fe,28,2,6,387,0,12327,387,
rw,28,3,171,222,74,12253,296,
goni,28,3,64,329,15,12312,344,
kenett,28,3,15,378,354,11973,732,
fe,28,3,9,384,0,12327,384,
rw,28,4,202,191,99,12228,290,
goni,28,4,93,300,24,12303,324,
kenett,28,4,17,376,370,11957,746,
fe,28,4,12,381,0,12327,381,
rw,28,5,240,153,131,12196,284,
goni,28,5,113,280,36,12291,316,
kenett,28,5,11,382,409,11918,791,
fe,28,5,15,378,0,12327,378,
rw,28,6,260,133,160,12167,293,
goni,28,6,135,258,42,12285,300,
kenett,28,6,15,378,420,11907,798,
fe,28,6,18,375,0,12327,375,
rw,28,7,287,106,183,12144,289,
goni,28,7,170,223,54,12273,277,
kenett,28,7,21,372,420,11907,792,
fe,28,7,21,372,0,12327,372,
rw,28,8,309,84,215,12112,299,
goni,28,8,182,211,68,12259,279,
kenett,28,8,15,378,441,11886,819,
fe,28,8,24,369,0,12327,369,
rw,28,9,319,74,239,12088,313,
goni,28,9,204,189,83,12244,272,
kenett,28,9,14,379,442,11885,821,
fe,28,9,27,366,0,12327,366,
rw,28,10,334,59,263,12064,322,
goni,28,10,226,167,93,12234,260,
kenett,28,10,19,374,446,11881,820,
fe,28,10,30,363,0,12327,363,
rw,28,11,340,53,296,12031,349,
goni,28,11,234,159,99,12228,258,
kenett,28,11,20,373,448,11879,821,
fe,28,11,32,361,0,12327,361,
rw,28,12,349,44,329,11998,373,
goni,28,12,253,140,106,12221,246,
kenett,28,12,38,355,433,11894,788,
fe,28,12,35,358,0,12327,358,
rw,28,13,353,40,362,11965,402,
goni,28,13,264,129,118,12209,247,
kenett,28,13,32,361,439,11888,800,
fe,28,13,38,355,0,12327,355,
rw,28,14,360,33,389,11938,422,
goni,28,14,277,116,130,12197,246,
kenett,28,14,34,359,437,11890,796,
fe,28,14,40,353,0,12327,353,
rw,28,15,365,28,417,11910,445,
goni,28,15,285,108,148,12179,256,
kenett,28,15,33,360,438,11889,798,
fe,28,15,42,351,0,12327,351,
rw,28,16,368,25,442,11885,467,
goni,28,16,300,93,154,12173,247,
kenett,28,16,226,167,248,12079,415,
fe,28,16,43,350,0,12327,350,
rw,28,17,372,21,461,11866,482,
goni,28,17,312,81,154,12173,235,
kenett,28,17,224,169,250,12077,419,
fe,28,17,46,347,0,12327,347,
rw,28,18,374,19,479,11848,498,
goni,28,18,319,74,171,12156,245,
kenett,28,18,240,153,234,12093,387,
fe,28,18,49,344,0,12327,344,
rw,28,19,375,18,508,11819,526,
goni,28,19,321,72,188,12139,260,
kenett,28,19,242,151,232,12095,383,
fe,28,19,52,341,0,12327,341,
rw,28,20,377,16,532,11795,548,
goni,28,20,328,65,195,12132,260,
kenett,28,20,243,150,231,12096,381,
fe,28,20,54,339,0,12327,339,
rw,28,21,380,13,560,11767,573,
goni,28,21,330,63,206,12121,269,
kenett,28,21,245,148,229,12098,377,
fe,28,21,55,338,0,12327,338,
rw,28,22,380,13,577,11750,590,
goni,28,22,335,58,211,12116,269,
kenett,28,22,242,151,232,12095,383,
fe,28,22,57,336,0,12327,336,
rw,28,23,382,11,603,11724,614,
goni,28,23,338,55,219,12108,274,
kenett,28,23,247,146,227,12100,373,
fe,28,23,60,333,0,12327,333,
rw,28,24,384,9,628,11699,637,
goni,28,24,342,51,235,12092,286,
kenett,28,24,250,143,224,12103,367,
fe,28,24,63,330,0,12327,330,
rw,28,25,384,9,642,11685,651,
goni,28,25,346,47,240,12087,287,
kenett,28,25,247,146,227,12100,373,
fe,28,25,66,327,0,12327,327,
rw,28,26,384,9,659,11668,668,
goni,28,26,350,43,247,12080,290,
kenett,28,26,255,138,219,12108,357,
fe,28,26,69,324,0,12327,324,
rw,28,27,384,9,686,11641,695,
goni,28,27,350,43,262,12065,305,
kenett,28,27,257,136,217,12110,353,
fe,28,27,71,322,0,12327,322,
rw,28,28,386,7,703,11624,710,
goni,28,28,354,39,268,12059,307,
kenett,28,28,256,137,218,12109,355,
fe,28,28,74,319,0,12327,319,
rw,28,29,386,7,718,11609,725,
goni,28,29,353,40,285,12042,325,
kenett,28,29,252,141,222,12105,363,
fe,28,29,76,317,0,12327,317,
rw,28,30,387,6,737,11590,743,
goni,28,30,360,33,289,12038,322,
kenett,28,30,250,143,224,12103,367,
fe,28,30,79,314,0,12327,314,
rw,28,31,388,5,747,11580,752,
goni,28,31,364,29,298,12029,327,
kenett,28,31,252,141,222,12105,363,
fe,28,31,80,313,0,12327,313,
rw,28,32,389,4,763,11564,767,
goni,28,32,365,28,296,12031,324,
kenett,28,32,253,140,221,12106,361,
fe,28,32,82,311,0,12327,311,
rw,28,33,389,4,781,11546,785,
goni,28,33,367,26,301,12026,327,
kenett,28,33,258,135,216,12111,351,
fe,28,33,82,311,0,12327,311,
rw,28,34,390,3,804,11523,807,
goni,28,34,367,26,311,12016,337,
kenett,28,34,259,134,215,12112,349,
fe,28,34,85,308,0,12327,308,
rw,28,35,391,2,822,11505,824,
goni,28,35,371,22,318,12009,340,
kenett,28,35,258,135,216,12111,351,
fe,28,35,88,305,0,12327,305,
rw,28,36,391,2,840,11487,842,
goni,28,36,372,21,322,12005,343,
kenett,28,36,263,130,211,12116,341,
fe,28,36,91,302,0,12327,302,
rw,28,37,391,2,857,11470,859,
goni,28,37,373,20,328,11999,348,
kenett,28,37,262,131,212,12115,343,
fe,28,37,93,300,0,12327,300,
rw,28,38,391,2,877,11450,879,
goni,28,38,376,17,333,11994,350,
kenett,28,38,258,135,216,12111,351,
fe,28,38,96,297,0,12327,297,
rw,28,39,392,1,889,11438,890,
goni,28,39,374,19,331,11996,350,
kenett,28,39,259,134,215,12112,349,
fe,28,39,97,296,0,12327,296,
rw,28,40,392,1,904,11423,905,
goni,28,40,376,17,341,11986,358,
kenett,28,40,259,134,215,12112,349,
fe,28,40,100,293,0,12327,293,
rw,28,41,392,1,921,11406,922,
goni,28,41,378,15,344,11983,359,
kenett,28,41,251,142,223,12104,365,
fe,28,41,102,291,0,12327,291,
rw,28,42,392,1,943,11384,944,
goni,28,42,377,16,344,11983,360,
kenett,28,42,258,135,216,12111,351,
fe,28,42,105,288,0,12327,288,
rw,28,43,393,0,968,11359,968,
goni,28,43,376,17,351,11976,368,
kenett,28,43,263,130,211,12116,341,
fe,28,43,107,286,0,12327,286,
rw,28,44,393,0,990,11337,990,
goni,28,44,376,17,362,11965,379,
kenett,28,44,259,134,215,12112,349,
fe,28,44,107,286,0,12327,286,
rw,28,45,393,0,1009,11318,1009,
goni,28,45,379,14,369,11958,383,
kenett,28,45,266,127,208,12119,335,
fe,28,45,109,284,0,12327,284,
rw,28,46,393,0,1031,11296,1031,
goni,28,46,381,12,372,11955,384,
kenett,28,46,263,130,211,12116,341,
fe,28,46,112,281,0,12327,281,
rw,28,47,393,0,1051,11276,1051,
goni,28,47,381,12,380,11947,392,
kenett,28,47,263,130,211,12116,341,
fe,28,47,114,279,0,12327,279,
rw,28,48,393,0,1068,11259,1068,
goni,28,48,381,12,389,11938,401,
kenett,28,48,270,123,204,12123,327,
fe,28,48,115,278,0,12327,278,
rw,28,49,393,0,1080,11247,1080,
goni,28,49,381,12,397,11930,409,
kenett,28,49,263,130,211,12116,341,
fe,28,49,117,276,0,12327,276,
rw,28,50,393,0,1100,11227,1100,
goni,28,50,381,12,405,11922,417,
kenett,28,50,273,120,201,12126,321,
fe,28,50,119,274,0,12327,274,
rw,29,1,80,313,17,12310,330,
goni,29,1,7,386,1,12326,387,
kenett,29,1,15,378,225,12102,603,
fe,29,1,3,390,0,12327,390,
rw,29,2,127,266,58,12269,324,
goni,29,2,31,362,6,12321,368,
kenett,29,2,9,384,318,12009,702,
fe,29,2,6,387,0,12327,387,
rw,29,3,169,224,93,12234,317,
goni,29,3,64,329,11,12316,340,
kenett,29,3,14,379,364,11963,743,
fe,29,3,9,384,0,12327,384,
rw,29,4,199,194,118,12209,312,
goni,29,4,82,311,25,12302,336,
kenett,29,4,12,381,378,11949,759,
fe,29,4,12,381,0,12327,381,
rw,29,5,234,159,148,12179,307,
goni,29,5,109,284,35,12292,319,
kenett,29,5,13,380,398,11929,778,
fe,29,5,15,378,0,12327,378,
rw,29,6,271,122,172,12155,294,
goni,29,6,140,253,49,12278,302,
kenett,29,6,17,376,421,11906,797,
fe,29,6,18,375,0,12327,375,
rw,29,7,286,107,195,12132,302,
goni,29,7,165,228,58,12269,286,
kenett,29,7,14,379,427,11900,806,
fe,29,7,20,373,0,12327,373,
rw,29,8,308,85,225,12102,310,
goni,29,8,188,205,67,12260,272,
kenett,29,8,16,377,437,11890,814,
fe,29,8,23,370,0,12327,370,
rw,29,9,322,71,262,12065,333,
goni,29,9,215,178,79,12248,257,
kenett,29,9,21,372,444,11883,816,
fe,29,9,26,367,0,12327,367,
rw,29,10,339,54,292,12035,346,
goni,29,10,228,165,92,12235,257,
kenett,29,10,25,368,446,11881,814,
fe,29,10,28,365,0,12327,365,
rw,29,11,354,39,313,12014,352,
goni,29,11,241,152,110,12217,262,
kenett,29,11,174,219,300,12027,519,
fe,29,11,31,362,0,12327,362,
rw,29,12,363,30,342,11985,372,
goni,29,12,260,133,125,12202,258,
kenett,29,12,189,204,285,12042,489,
fe,29,12,32,361,0,12327,361,
rw,29,13,368,25,366,11961,391,
goni,29,13,270,123,138,12189,261,
kenett,29,13,188,205,286,12041,491,
fe,29,13,35,358,0,12327,358,
rw,29,14,371,22,399,11928,421,
goni,29,14,279,114,144,12183,258,
kenett,29,14,194,199,280,12047,479,
fe,29,14,38,355,0,12327,355,
rw,29,15,378,15,418,11909,433,
goni,29,15,288,105,152,12175,257,
kenett,29,15,198,195,276,12051,471,
fe,29,15,41,352,0,12327,352,
rw,29,16,382,11,446,11881,457,
goni,29,16,307,86,164,12163,250,
kenett,29,16,197,196,277,12050,473,
fe,29,16,44,349,0,12327,349,
rw,29,17,383,10,467,11860,477,
goni,29,17,308,85,174,12153,259,
kenett,29,17,208,185,266,12061,451,
fe,29,17,46,347,0,12327,347,
rw,29,18,384,9,498,11829,507,
goni,29,18,315,78,191,12136,269,
kenett,29,18,218,175,256,12071,431,
fe,29,18,49,344,0,12327,344,
rw,29,19,386,7,523,11804,530,
goni,29,19,321,72,210,12117,282,
kenett,29,19,232,161,242,12085,403,
fe,29,19,52,341,0,12327,341,
rw,29,20,387,6,548,11779,554,
goni,29,20,329,64,214,12113,278,
kenett,29,20,216,177,258,12069,435,
fe,29,20,54,339,0,12327,339,
rw,29,21,388,5,564,11763,569,
goni,29,21,337,56,214,12113,270,
kenett,29,21,220,173,254,12073,427,
fe,29,21,56,337,0,12327,337,
rw,29,22,389,4,588,11739,592,
goni,29,22,340,53,221,12106,274,
kenett,29,22,223,170,251,12076,421,
fe,29,22,58,335,0,12327,335,
rw,29,23,390,3,607,11720,610,
goni,29,23,348,45,231,12096,276,
kenett,29,23,226,167,248,12079,415,
fe,29,23,61,332,0,12327,332,
rw,29,24,390,3,631,11696,634,
goni,29,24,351,42,242,12085,284,
kenett,29,24,231,162,243,12084,405,
fe,29,24,64,329,0,12327,329,
rw,29,25,391,2,652,11675,654,
goni,29,25,346,47,245,12082,292,
kenett,29,25,232,161,242,12085,403,
fe,29,25,65,328,0,12327,328,
rw,29,26,391,2,670,11657,672,
goni,29,26,348,45,259,12068,304,
kenett,29,26,239,154,235,12092,389,
fe,29,26,68,325,0,12327,325,
rw,29,27,391,2,684,11643,686,
goni,29,27,352,41,273,12054,314,
kenett,29,27,240,153,234,12093,387,
fe,29,27,71,322,0,12327,322,
rw,29,28,391,2,703,11624,705,
goni,29,28,355,38,291,12036,329,
kenett,29,28,236,157,238,12089,395,
fe,29,28,74,319,0,12327,319,
rw,29,29,391,2,731,11596,733,
goni,29,29,356,37,300,12027,337,
kenett,29,29,243,150,231,12096,381,
fe,29,29,75,318,0,12327,318,
rw,29,30,391,2,754,11573,756,
goni,29,30,356,37,311,12016,348,
kenett,29,30,250,143,224,12103,367,
fe,29,30,78,315,0,12327,315,
rw,29,31,391,2,777,11550,779,
goni,29,31,358,35,317,12010,352,
kenett,29,31,255,138,219,12108,357,
fe,29,31,80,313,0,12327,313,
rw,29,32,392,1,788,11539,789,
goni,29,32,360,33,323,12004,356,
kenett,29,32,253,140,221,12106,361,
fe,29,32,82,311,0,12327,311,
rw,29,33,392,1,801,11526,802,
goni,29,33,360,33,328,11999,361,
kenett,29,33,257,136,217,12110,353,
fe,29,33,84,309,0,12327,309,
rw,29,34,393,0,814,11513,814,
goni,29,34,362,31,344,11983,375,
kenett,29,34,258,135,216,12111,351,
fe,29,34,84,309,0,12327,309,
rw,29,35,393,0,824,11503,824,
goni,29,35,366,27,345,11982,372,
kenett,29,35,259,134,215,12112,349,
fe,29,35,86,307,0,12327,307,
rw,29,36,393,0,837,11490,837,
goni,29,36,368,25,347,11980,372,
kenett,29,36,253,140,221,12106,361,
fe,29,36,86,307,0,12327,307,
rw,29,37,393,0,855,11472,855,
goni,29,37,369,24,348,11979,372,
kenett,29,37,262,131,212,12115,343,
fe,29,37,87,306,0,12327,306,
rw,29,38,393,0,876,11451,876,
goni,29,38,373,20,358,11969,378,
kenett,29,38,262,131,212,12115,343,
fe,29,38,88,305,0,12327,305,
rw,29,39,393,0,897,11430,897,
goni,29,39,372,21,362,11965,383,
kenett,29,39,267,126,207,12120,333,
fe,29,39,89,304,0,12327,304,
rw,29,40,393,0,917,11410,917,
goni,29,40,374,19,364,11963,383,
kenett,29,40,263,130,211,12116,341,
fe,29,40,92,301,0,12327,301,
rw,29,41,393,0,929,11398,929,
goni,29,41,373,20,370,11957,390,
kenett,29,41,267,126,207,12120,333,
fe,29,41,94,299,0,12327,299,
rw,29,42,393,0,947,11380,947,
goni,29,42,374,19,371,11956,390,
kenett,29,42,268,125,206,12121,331,
fe,29,42,97,296,0,12327,296,
rw,29,43,393,0,963,11364,963,
goni,29,43,373,20,377,11950,397,
kenett,29,43,268,125,206,12121,331,
fe,29,43,98,295,0,12327,295,
rw,29,44,393,0,984,11343,984,
goni,29,44,375,18,376,11951,394,
kenett,29,44,272,121,202,12125,323,
fe,29,44,101,292,0,12327,292,
rw,29,45,393,0,1004,11323,1004,
goni,29,45,375,18,378,11949,396,
kenett,29,45,273,120,201,12126,321,
fe,29,45,104,289,0,12327,289,
rw,29,46,393,0,1025,11302,1025,
goni,29,46,377,16,381,11946,397,
kenett,29,46,264,129,210,12117,339,
fe,29,46,106,287,0,12327,287,
rw,29,47,393,0,1040,11287,1040,
goni,29,47,376,17,384,11943,401,
kenett,29,47,277,116,197,12130,313,
fe,29,47,108,285,0,12327,285,
rw,29,48,393,0,1055,11272,1055,
goni,29,48,378,15,394,11933,409,
kenett,29,48,274,119,200,12127,319,
fe,29,48,110,283,0,12327,283,
rw,29,49,393,0,1066,11261,1066,
goni,29,49,381,12,402,11925,414,
kenett,29,49,276,117,198,12129,315,
fe,29,49,111,282,0,12327,282,
rw,29,50,393,0,1082,11245,1082,
goni,29,50,380,13,413,11914,426,
kenett,29,50,271,122,203,12124,325,
fe,29,50,113,280,0,12327,280,
rw,30,1,69,324,28,12299,352,
goni,30,1,8,385,0,12327,385,
kenett,30,1,5,388,241,12086,629,
fe,30,1,3,390,0,12327,390,
rw,30,2,119,274,63,12264,337,
goni,30,2,29,364,8,12319,372,
kenett,30,2,14,379,334,11993,713,
fe,30,2,6,387,0,12327,387,
rw,30,3,164,229,96,12231,325,
goni,30,3,65,328,18,12309,346,
kenett,30,3,17,376,373,11954,749,
fe,30,3,9,384,0,12327,384,
rw,30,4,191,202,129,12198,331,
goni,30,4,84,309,25,12302,334,
kenett,30,4,19,374,392,11935,766,
fe,30,4,12,381,0,12327,381,
rw,30,5,224,169,165,12162,334,
goni,30,5,112,281,33,12294,314,
kenett,30,5,14,379,424,11903,803,
fe,30,5,15,378,0,12327,378,
rw,30,6,248,145,193,12134,338,
goni,30,6,128,265,41,12286,306,
kenett,30,6,16,377,428,11899,805,
fe,30,6,18,375,0,12327,375,
rw,30,7,273,120,225,12102,345,
goni,30,7,161,232,54,12273,286,
kenett,30,7,13,380,437,11890,817,
fe,30,7,21,372,0,12327,372,
rw,30,8,294,99,254,12073,353,
goni,30,8,182,211,70,12257,281,
kenett,30,8,13,380,443,11884,823,
fe,30,8,24,369,0,12327,369,
rw,30,9,314,79,286,12041,365,
goni,30,9,192,201,79,12248,280,
kenett,30,9,20,373,448,11879,821,
fe,30,9,27,366,0,12327,366,
rw,30,10,331,62,308,12019,370,
goni,30,10,218,175,104,12223,279,
kenett,30,10,31,362,437,11890,799,
fe,30,10,30,363,0,12327,363,
rw,30,11,337,56,334,11993,390,
goni,30,11,235,158,115,12212,273,
kenett,30,11,22,371,446,11881,817,
fe,30,11,32,361,0,12327,361,
rw,30,12,346,47,358,11969,405,
goni,30,12,247,146,127,12200,273,
kenett,30,12,22,371,446,11881,817,
fe,30,12,35,358,0,12327,358,
rw,30,13,353,40,378,11949,418,
goni,30,13,256,137,141,12186,278,
kenett,30,13,20,373,448,11879,821,
fe,30,13,38,355,0,12327,355,
rw,30,14,358,35,406,11921,441,
goni,30,14,264,129,158,12169,287,
kenett,30,14,28,365,440,11887,805,
fe,30,14,41,352,0,12327,352,
rw,30,15,363,30,425,11902,455,
goni,30,15,279,114,157,12170,271,
kenett,30,15,30,363,438,11889,801,
fe,30,15,43,350,0,12327,350,
rw,30,16,369,24,448,11879,472,
goni,30,16,288,105,172,12155,277,
kenett,30,16,32,361,439,11888,800,
fe,30,16,45,348,0,12327,348,
rw,30,17,377,16,481,11846,497,
goni,30,17,298,95,182,12145,277,
kenett,30,17,202,191,272,12055,463,
fe,30,17,48,345,0,12327,345,
rw,30,18,377,16,512,11815,528,
goni,30,18,307,86,182,12145,268,
kenett,30,18,209,184,265,12062,449,
fe,30,18,50,343,0,12327,343,
rw,30,19,379,14,537,11790,551,
goni,30,19,312,81,194,12133,275,
kenett,30,19,208,185,266,12061,451,
fe,30,19,53,340,0,12327,340,
rw,30,20,380,13,553,11774,566,
goni,30,20,319,74,216,12111,290,
kenett,30,20,216,177,258,12069,435,
fe,30,20,55,338,0,12327,338,
rw,30,21,381,12,576,11751,588,
goni,30,21,325,68,224,12103,292,
kenett,30,21,218,175,256,12071,431,
fe,30,21,58,335,0,12327,335,
rw,30,22,383,10,590,11737,600,
goni,30,22,329,64,237,12090,301,
kenett,30,22,217,176,257,12070,433,
fe,30,22,61,332,0,12327,332,
rw,30,23,385,8,610,11717,618,
goni,30,23,330,63,251,12076,314,
kenett,30,23,218,175,256,12071,431,
fe,30,23,64,329,0,12327,329,
rw,30,24,386,7,628,11699,635,
goni,30,24,341,52,254,12073,306,
kenett,30,24,226,167,248,12079,415,
fe,30,24,67,326,0,12327,326,
rw,30,25,388,5,648,11679,653,
goni,30,25,344,49,263,12064,312,
kenett,30,25,226,167,248,12079,415,
fe,30,25,69,324,0,12327,324,
rw,30,26,388,5,670,11657,675,
goni,30,26,347,46,281,12046,327,
kenett,30,26,236,157,238,12089,395,
fe,30,26,71,322,0,12327,322,
rw,30,27,388,5,687,11640,692,
goni,30,27,347,46,279,12048,325,
kenett,30,27,231,162,243,12084,405,
fe,30,27,73,320,0,12327,320,
rw,30,28,388,5,716,11611,721,
goni,30,28,349,44,280,12047,324,
kenett,30,28,235,158,239,12088,397,
fe,30,28,76,317,0,12327,317,
rw,30,29,388,5,737,11590,742,
goni,30,29,349,44,288,12039,332,
kenett,30,29,238,155,236,12091,391,
fe,30,29,78,315,0,12327,315,
rw,30,30,389,4,756,11571,760,
goni,30,30,351,42,297,12030,339,
kenett,30,30,240,153,234,12093,387,
fe,30,30,80,313,0,12327,313,
rw,30,31,389,4,766,11561,770,
goni,30,31,361,32,302,12025,334,
kenett,30,31,235,158,239,12088,397,
fe,30,31,83,310,0,12327,310,
rw,30,32,390,3,789,11538,792,
goni,30,32,361,32,311,12016,343,
kenett,30,32,243,150,231,12096,381,
fe,30,32,85,308,0,12327,308,
rw,30,33,390,3,809,11518,812,
goni,30,33,361,32,308,12019,340,
kenett,30,33,246,147,228,12099,375,
fe,30,33,88,305,0,12327,305,
rw,30,34,390,3,834,11493,837,
goni,30,34,366,27,318,12009,345,
kenett,30,34,249,144,225,12102,369,
fe,30,34,90,303,0,12327,303,
rw,30,35,390,3,851,11476,854,
goni,30,35,365,28,322,12005,350,
kenett,30,35,253,140,221,12106,361,
fe,30,35,90,303,0,12327,303,
rw,30,36,390,3,867,11460,870,
goni,30,36,365,28,330,11997,358,
kenett,30,36,257,136,217,12110,353,
fe,30,36,93,300,0,12327,300,
rw,30,37,390,3,894,11433,897,
goni,30,37,367,26,334,11993,360,
kenett,30,37,262,131,212,12115,343,
fe,30,37,96,297,0,12327,297,
rw,30,38,390,3,918,11409,921,
goni,30,38,367,26,336,11991,362,
kenett,30,38,261,132,213,12114,345,
fe,30,38,97,296,0,12327,296,
rw,30,39,390,3,937,11390,940,
goni,30,39,367,26,342,11985,368,
kenett,30,39,256,137,218,12109,355,
fe,30,39,99,294,0,12327,294,
rw,30,40,390,3,961,11366,964,
goni,30,40,368,25,345,11982,370,
kenett,30,40,261,132,213,12114,345,
fe,30,40,101,292,0,12327,292,
rw,30,41,390,3,979,11348,982,
goni,30,41,366,27,345,11982,372,
kenett,30,41,261,132,213,12114,345,
fe,30,41,103,290,0,12327,290,
rw,30,42,390,3,993,11334,996,
goni,30,42,367,26,358,11969,384,
kenett,30,42,260,133,214,12113,347,
fe,30,42,106,287,0,12327,287,
rw,30,43,390,3,1007,11320,1010,
goni,30,43,369,24,360,11967,384,
kenett,30,43,256,137,218,12109,355,
fe,30,43,108,285,0,12327,285,
rw,30,44,391,2,1024,11303,1026,
goni,30,44,372,21,362,11965,383,
kenett,30,44,264,129,210,12117,339,
fe,30,44,111,282,0,12327,282,
rw,30,45,392,1,1044,11283,1045,
goni,30,45,372,21,367,11960,388,
kenett,30,45,266,127,208,12119,335,
fe,30,45,113,280,0,12327,280,
rw,30,46,392,1,1066,11261,1067,
goni,30,46,372,21,373,11954,394,
kenett,30,46,269,124,205,12122,329,
fe,30,46,114,279,0,12327,279,
rw,30,47,392,1,1083,11244,1084,
goni,30,47,373,20,378,11949,398,
kenett,30,47,270,123,204,12123,327,
fe,30,47,116,277,0,12327,277,
rw,30,48,392,1,1101,11226,1102,
goni,30,48,373,20,380,11947,400,
kenett,30,48,268,125,206,12121,331,
fe,30,48,119,274,0,12327,274,
rw,30,49,392,1,1123,11204,1124,
goni,30,49,374,19,384,11943,403,
kenett,30,49,266,127,208,12119,335,
fe,30,49,120,273,0,12327,273,
rw,30,50,392,1,1141,11186,1142,
goni,30,50,378,15,391,11936,406,
kenett,30,50,269,124,205,12122,329,
fe,30,50,121,272,0,12327,272,
rw,31,1,61,332,40,12287,372,
goni,31,1,2,391,0,12327,391,
kenett,31,1,14,379,262,12065,641,
fe,31,1,3,390,0,12327,390,
rw,31,2,119,274,66,12261,340,
goni,31,2,25,368,4,12323,372,
kenett,31,2,16,377,353,11974,730,
fe,31,2,6,387,0,12327,387,
rw,31,3,161,232,100,12227,332,
goni,31,3,55,338,15,12312,353,
kenett,31,3,18,375,381,11946,756,
fe,31,3,9,384,0,12327,384,
rw,31,4,192,201,130,12197,331,
goni,31,4,88,305,19,12308,324,
kenett,31,4,18,375,408,11919,783,
fe,31,4,12,381,0,12327,381,
rw,31,5,221,172,155,12172,327,
goni,31,5,114,279,22,12305,301,
kenett,31,5,14,379,427,11900,806,
fe,31,5,15,378,0,12327,378,
rw,31,6,238,155,177,12150,332,
goni,31,6,135,258,34,12293,292,
kenett,31,6,23,370,436,11891,806,
fe,31,6,18,375,0,12327,375,
rw,31,7,262,131,206,12121,337,
goni,31,7,158,235,46,12281,281,
kenett,31,7,17,376,448,11879,824,
fe,31,7,21,372,0,12327,372,
rw,31,8,278,115,235,12092,350,
goni,31,8,178,215,55,12272,270,
kenett,31,8,20,373,445,11882,818,
fe,31,8,24,369,0,12327,369,
rw,31,9,296,97,261,12066,358,
goni,31,9,199,194,78,12249,272,
kenett,31,9,39,354,432,11895,786,
fe,31,9,27,366,0,12327,366,
rw,31,10,313,80,298,12029,378,
goni,31,10,214,179,90,12237,269,
kenett,31,10,177,216,297,12030,513,
fe,31,10,30,363,0,12327,363,
rw,31,11,324,69,321,12006,390,
goni,31,11,232,161,106,12221,267,
kenett,31,11,189,204,285,12042,489,
fe,31,11,33,360,0,12327,360,
rw,31,12,334,59,341,11986,400,
goni,31,12,248,145,117,12210,262,
kenett,31,12,187,206,287,12040,493,
fe,31,12,36,357,0,12327,357,
rw,31,13,344,49,367,11960,416,
goni,31,13,267,126,129,12198,255,
kenett,31,13,198,195,276,12051,471,
fe,31,13,39,354,0,12327,354,
rw,31,14,352,41,396,11931,437,
goni,31,14,285,108,137,12190,245,
kenett,31,14,204,189,270,12057,459,
fe,31,14,42,351,0,12327,351,
rw,31,15,358,35,422,11905,457,
goni,31,15,288,105,147,12180,252,
kenett,31,15,206,187,268,12059,455,
fe,31,15,44,349,0,12327,349,
rw,31,16,363,30,443,11884,473,
goni,31,16,301,92,153,12174,245,
kenett,31,16,212,181,262,12065,443,
fe,31,16,47,346,0,12327,346,
rw,31,17,368,25,465,11862,490,
goni,31,17,303,90,165,12162,255,
kenett,31,17,227,166,247,12080,413,
fe,31,17,50,343,0,12327,343,
rw,31,18,371,22,488,11839,510,
goni,31,18,307,86,171,12156,257,
kenett,31,18,225,168,249,12078,417,
fe,31,18,53,340,0,12327,340,
rw,31,19,375,18,508,11819,526,
goni,31,19,312,81,181,12146,262,
kenett,31,19,223,170,251,12076,421,
fe,31,19,56,337,0,12327,337,
rw,31,20,376,17,536,11791,553,
goni,31,20,321,72,194,12133,266,
kenett,31,20,233,160,241,12086,401,
fe,31,20,59,334,0,12327,334,
rw,31,21,380,13,560,11767,573,
goni,31,21,323,70,201,12126,271,
kenett,31,21,230,163,244,12083,407,
fe,31,21,60,333,0,12327,333,
rw,31,22,381,12,592,11735,604,
goni,31,22,331,62,208,12119,270,
kenett,31,22,238,155,236,12091,391,
fe,31,22,63,330,0,12327,330,
rw,31,23,382,11,615,11712,626,
goni,31,23,331,62,215,12112,277,
kenett,31,23,237,156,237,12090,393,
fe,31,23,66,327,0,12327,327,
rw,31,24,382,11,645,11682,656,
goni,31,24,339,54,221,12106,275,
kenett,31,24,243,150,231,12096,381,
fe,31,24,69,324,0,12327,324,
rw,31,25,383,10,660,11667,670,
goni,31,25,348,45,231,12096,276,
kenett,31,25,243,150,231,12096,381,
fe,31,25,72,321,0,12327,321,
rw,31,26,383,10,681,11646,691,
goni,31,26,350,43,232,12095,275,
kenett,31,26,239,154,235,12092,389,
fe,31,26,75,318,0,12327,318,
rw,31,27,383,10,710,11617,720,
goni,31,27,351,42,244,12083,286,
kenett,31,27,247,146,227,12100,373,
fe,31,27,78,315,0,12327,315,
rw,31,28,383,10,739,11588,749,
goni,31,28,352,41,256,12071,297,
kenett,31,28,254,139,220,12107,359,
fe,31,28,80,313,0,12327,313,
rw,31,29,385,8,758,11569,766,
goni,31,29,356,37,263,12064,300,
kenett,31,29,251,142,223,12104,365,
fe,31,29,83,310,0,12327,310,
rw,31,30,385,8,779,11548,787,
goni,31,30,361,32,276,12051,308,
kenett,31,30,249,144,225,12102,369,
fe,31,30,85,308,0,12327,308,
rw,31,31,386,7,797,11530,804,
goni,31,31,361,32,280,12047,312,
kenett,31,31,252,141,222,12105,363,
fe,31,31,87,306,0,12327,306,
rw,31,32,386,7,807,11520,814,
goni,31,32,364,29,279,12048,308,
kenett,31,32,256,137,218,12109,355,
fe,31,32,90,303,0,12327,303,
rw,31,33,386,7,830,11497,837,
goni,31,33,367,26,292,12035,318,
kenett,31,33,252,141,222,12105,363,
fe,31,33,90,303,0,12327,303,
rw,31,34,386,7,853,11474,860,
goni,31,34,368,25,289,12038,314,
kenett,31,34,263,130,211,12116,341,
fe,31,34,93,300,0,12327,300,
rw,31,35,387,6,871,11456,877,
goni,31,35,367,26,291,12036,317,
kenett,31,35,263,130,211,12116,341,
fe,31,35,95,298,0,12327,298,
rw,31,36,388,5,891,11436,896,
goni,31,36,370,23,302,12025,325,
kenett,31,36,260,133,214,12113,347,
fe,31,36,98,295,0,12327,295,
rw,31,37,388,5,917,11410,922,
goni,31,37,370,23,310,12017,333,
kenett,31,37,250,143,224,12103,367,
fe,31,37,101,292,0,12327,292,
rw,31,38,388,5,933,11394,938,
goni,31,38,371,22,324,12003,346,
kenett,31,38,261,132,213,12114,345,
fe,31,38,102,291,0,12327,291,
rw,31,39,388,5,947,11380,952,
goni,31,39,370,23,326,12001,349,
kenett,31,39,260,133,214,12113,347,
fe,31,39,105,288,0,12327,288,
rw,31,40,389,4,963,11364,967,
goni,31,40,372,21,335,11992,356,
kenett,31,40,266,127,208,12119,335,
fe,31,40,107,286,0,12327,286,
rw,31,41,389,4,979,11348,983,
goni,31,41,371,22,344,11983,366,
kenett,31,41,270,123,204,12123,327,
fe,31,41,110,283,0,12327,283,
rw,31,42,391,2,999,11328,1001,
goni,31,42,377,16,346,11981,362,
kenett,31,42,265,128,209,12118,337,
fe,31,42,111,282,0,12327,282,
rw,31,43,391,2,1016,11311,1018,
goni,31,43,379,14,343,11984,357,
kenett,31,43,265,128,209,12118,337,
fe,31,43,114,279,0,12327,279,
rw,31,44,391,2,1028,11299,1030,
goni,31,44,379,14,348,11979,362,
kenett,31,44,259,134,215,12112,349,
fe,31,44,116,277,0,12327,277,
rw,31,45,391,2,1047,11280,1049,
goni,31,45,380,13,358,11969,371,
kenett,31,45,263,130,211,12116,341,
fe,31,45,119,274,0,12327,274,
rw,31,46,391,2,1061,11266,1063,
goni,31,46,380,13,366,11961,379,
kenett,31,46,261,132,213,12114,345,
fe,31,46,122,271,0,12327,271,
rw,31,47,391,2,1075,11252,1077,
goni,31,47,381,12,374,11953,386,
kenett,31,47,266,127,208,12119,335,
fe,31,47,123,270,0,12327,270,
rw,31,48,392,1,1095,11232,1096,
goni,31,48,381,12,389,11938,401,
kenett,31,48,263,130,211,12116,341,
fe,31,48,125,268,0,12327,268,
rw,31,49,392,1,1114,11213,1115,
goni,31,49,383,10,389,11938,399,
kenett,31,49,265,128,209,12118,337,
fe,31,49,126,267,0,12327,267,
rw,31,50,392,1,1135,11192,1136,
goni,31,50,383,10,406,11921,416,
kenett,31,50,266,127,208,12119,335,
fe,31,50,128,265,0,12327,265,
rw,32,1,68,325,30,12297,355,
goni,32,1,6,387,0,12327,387,
kenett,32,1,20,373,217,12110,590,
fe,32,1,3,390,0,12327,390,
rw,32,2,130,263,51,12276,314,
goni,32,2,31,362,5,12322,367,
kenett,32,2,16,377,323,12004,700,
fe,32,2,6,387,0,12327,387,
rw,32,3,182,211,78,12249,289,
goni,32,3,60,333,17,12310,350,
kenett,32,3,19,374,389,11938,763,
fe,32,3,9,384,0,12327,384,
rw,32,4,212,181,108,12219,289,
goni,32,4,87,306,26,12301,332,
kenett,32,4,17,376,406,11921,782,
fe,32,4,12,381,0,12327,381,
rw,32,5,246,147,139,12188,286,
goni,32,5,117,276,44,12283,320,
kenett,32,5,19,374,434,11893,808,
fe,32,5,15,378,0,12327,378,
rw,32,6,273,120,160,12167,280,
goni,32,6,153,240,49,12278,289,
kenett,32,6,15,378,447,11880,825,
fe,32,6,18,375,0,12327,375,
rw,32,7,292,101,190,12137,291,
goni,32,7,178,215,58,12269,273,
kenett,32,7,21,372,447,11880,819,
fe,32,7,21,372,0,12327,372,
rw,32,8,310,83,220,12107,303,
goni,32,8,188,205,76,12251,281,
kenett,32,8,21,372,450,11877,822,
fe,32,8,23,370,0,12327,370,
rw,32,9,328,65,246,12081,311,
goni,32,9,215,178,94,12233,272,
kenett,32,9,159,234,315,12012,549,
fe,32,9,25,368,0,12327,368,
rw,32,10,338,55,271,12056,326,
goni,32,10,234,159,112,12215,271,
kenett,32,10,176,217,298,12029,515,
fe,32,10,28,365,0,12327,365,
rw,32,11,347,46,299,12028,345,
goni,32,11,246,147,129,12198,276,
kenett,32,11,179,214,295,12032,509,
fe,32,11,30,363,0,12327,363,
rw,32,12,356,37,322,12005,359,
goni,32,12,268,125,145,12182,270,
kenett,32,12,186,207,288,12039,495,
fe,32,12,33,360,0,12327,360,
rw,32,13,360,33,341,11986,374,
goni,32,13,277,116,151,12176,267,
kenett,32,13,193,200,281,12046,481,
fe,32,13,36,357,0,12327,357,
rw,32,14,362,31,365,11962,396,
goni,32,14,288,105,165,12162,270,
kenett,32,14,200,193,274,12053,467,
fe,32,14,38,355,0,12327,355,
rw,32,15,367,26,387,11940,413,
goni,32,15,294,99,164,12163,263,
kenett,32,15,202,191,272,12055,463,
fe,32,15,40,353,0,12327,353,
rw,32,16,371,22,416,11911,438,
goni,32,16,297,96,177,12150,273,
kenett,32,16,205,188,269,12058,457,
fe,32,16,42,351,0,12327,351,
rw,32,17,373,20,445,11882,465,
goni,32,17,299,94,191,12136,285,
kenett,32,17,216,177,258,12069,435,
fe,32,17,45,348,0,12327,348,
rw,32,18,377,16,467,11860,483,
goni,32,18,311,82,197,12130,279,
kenett,32,18,215,178,259,12068,437,
fe,32,18,48,345,0,12327,345,
rw,32,19,378,15,487,11840,502,
goni,32,19,317,76,203,12124,279,
kenett,32,19,217,176,257,12070,433,
fe,32,19,51,342,0,12327,342,
rw,32,20,381,12,511,11816,523,
goni,32,20,319,74,214,12113,288,
kenett,32,20,224,169,250,12077,419,
fe,32,20,53,340,0,12327,340,
rw,32,21,382,11,525,11802,536,
goni,32,21,321,72,225,12102,297,
kenett,32,21,223,170,251,12076,421,
fe,32,21,56,337,0,12327,337,
rw,32,22,383,10,545,11782,555,
goni,32,22,328,65,227,12100,292,
kenett,32,22,232,161,242,12085,403,
fe,32,22,59,334,0,12327,334,
rw,32,23,384,9,568,11759,577,
goni,32,23,337,56,232,12095,288,
kenett,32,23,232,161,242,12085,403,
fe,32,23,61,332,0,12327,332,
rw,32,24,386,7,586,11741,593,
goni,32,24,345,48,244,12083,292,
kenett,32,24,239,154,235,12092,389,
fe,32,24,64,329,0,12327,329,
rw,32,25,388,5,606,11721,611,
goni,32,25,343,50,255,12072,305,
kenett,32,25,255,138,219,12108,357,
fe,32,25,66,327,0,12327,327,
rw,32,26,388,5,625,11702,630,
goni,32,26,349,44,256,12071,300,
kenett,32,26,258,135,216,12111,351,
fe,32,26,69,324,0,12327,324,
rw,32,27,389,4,646,11681,650,
goni,32,27,348,45,271,12056,316,
kenett,32,27,257,136,217,12110,353,
fe,32,27,72,321,0,12327,321,
rw,32,28,390,3,663,11664,666,
goni,32,28,349,44,269,12058,313,
kenett,32,28,251,142,223,12104,365,
fe,32,28,75,318,0,12327,318,
rw,32,29,390,3,690,11637,693,
goni,32,29,353,40,286,12041,326,
kenett,32,29,250,143,224,12103,367,
fe,32,29,77,316,0,12327,316,
rw,32,30,390,3,705,11622,708,
goni,32,30,357,36,284,12043,320,
kenett,32,30,254,139,220,12107,359,
fe,32,30,80,313,0,12327,313,
rw,32,31,391,2,723,11604,725,
goni,32,31,359,34,299,12028,333,
kenett,32,31,260,133,214,12113,347,
fe,32,31,83,310,0,12327,310,
rw,32,32,391,2,748,11579,750,
goni,32,32,361,32,303,12024,335,
kenett,32,32,255,138,219,12108,357,
fe,32,32,86,307,0,12327,307,
rw,32,33,391,2,772,11555,774,
goni,32,33,361,32,319,12008,351,
kenett,32,33,265,128,209,12118,337,
fe,32,33,88,305,0,12327,305,
rw,32,34,391,2,790,11537,792,
goni,32,34,363,30,327,12000,357,
kenett,32,34,260,133,214,12113,347,
fe,32,34,90,303,0,12327,303,
rw,32,35,391,2,810,11517,812,
goni,32,35,367,26,325,12002,351,
kenett,32,35,257,136,217,12110,353,
fe,32,35,92,301,0,12327,301,
rw,32,36,392,1,825,11502,826,
goni,32,36,367,26,328,11999,354,
kenett,32,36,254,139,220,12107,359,
fe,32,36,92,301,0,12327,301,
rw,32,37,392,1,841,11486,842,
goni,32,37,366,27,331,11996,358,
kenett,32,37,263,130,211,12116,341,
fe,32,37,95,298,0,12327,298,
rw,32,38,392,1,862,11465,863,
goni,32,38,368,25,344,11983,369,
kenett,32,38,266,127,208,12119,335,
fe,32,38,97,296,0,12327,296,
rw,32,39,392,1,877,11450,878,
goni,32,39,370,23,351,11976,374,
kenett,32,39,259,134,215,12112,349,
fe,32,39,100,293,0,12327,293,
rw,32,40,392,1,902,11425,903,
goni,32,40,372,21,352,11975,373,
kenett,32,40,264,129,210,12117,339,
fe,32,40,102,291,0,12327,291,
rw,32,41,392,1,917,11410,918,
goni,32,41,372,21,361,11966,382,
kenett,32,41,267,126,207,12120,333,
fe,32,41,103,290,0,12327,290,
rw,32,42,392,1,931,11396,932,
goni,32,42,373,20,367,11960,387,
kenett,32,42,266,127,208,12119,335,
fe,32,42,106,287,0,12327,287,
rw,32,43,392,1,952,11375,953,
goni,32,43,375,18,371,11956,389,
kenett,32,43,266,127,208,12119,335,
fe,32,43,108,285,0,12327,285,
rw,32,44,392,1,971,11356,972,
goni,32,44,376,17,384,11943,401,
kenett,32,44,264,129,210,12117,339,
fe,32,44,111,282,0,12327,282,
rw,32,45,392,1,983,11344,984,
goni,32,45,377,16,391,11936,407,
kenett,32,45,261,132,213,12114,345,
fe,32,45,113,280,0,12327,280,
rw,32,46,392,1,999,11328,1000,
goni,32,46,377,16,398,11929,414,
kenett,32,46,269,124,205,12122,329,
fe,32,46,115,278,0,12327,278,
rw,32,47,392,1,1019,11308,1020,
goni,32,47,376,17,402,11925,419,
kenett,32,47,271,122,203,12124,325,
fe,32,47,117,276,0,12327,276,
rw,32,48,392,1,1037,11290,1038,
goni,32,48,376,17,408,11919,425,
kenett,32,48,273,120,201,12126,321,
fe,32,48,119,274,0,12327,274,
rw,32,49,392,1,1050,11277,1051,
goni,32,49,378,15,414,11913,429,
kenett,32,49,275,118,199,12128,317,
fe,32,49,122,271,0,12327,271,
rw,32,50,392,1,1076,11251,1077,
goni,32,50,379,14,423,11904,437,
kenett,32,50,281,112,193,12134,305,
fe,32,50,125,268,0,12327,268,
rw,33,1,76,317,20,12307,337,
goni,33,1,12,381,2,12325,383,
kenett,33,1,11,382,205,12122,587,
fe,33,1,2,391,0,12327,391,
rw,33,2,128,265,47,12280,312,
goni,33,2,47,346,7,12320,353,
kenett,33,2,13,380,305,12022,685,
fe,33,2,5,388,0,12327,388,
rw,33,3,173,220,71,12256,291,
goni,33,3,75,318,14,12313,332,
kenett,33,3,12,381,363,11964,744,
fe,33,3,8,385,0,12327,385,
rw,33,4,214,179,103,12224,282,
goni,33,4,90,303,34,12293,337,
kenett,33,4,19,374,398,11929,772,
fe,33,4,11,382,0,12327,382,
rw,33,5,238,155,133,12194,288,
goni,33,5,114,279,48,12279,327,
kenett,33,5,18,375,414,11913,789,
fe,33,5,14,379,0,12327,379,
rw,33,6,265,128,158,12169,286,
goni,33,6,144,249,56,12271,305,
kenett,33,6,15,378,432,11895,810,
fe,33,6,17,376,0,12327,376,
rw,33,7,280,113,185,12142,298,
goni,33,7,161,232,76,12251,308,
kenett,33,7,18,375,438,11889,813,
fe,33,7,19,374,0,12327,374,
rw,33,8,298,95,224,12103,319,
goni,33,8,179,214,93,12234,307,
kenett,33,8,15,378,450,11877,828,
fe,33,8,22,371,0,12327,371,
rw,33,9,312,81,258,12069,339,
goni,33,9,197,196,92,12235,288,
kenett,33,9,18,375,447,11880,822,
fe,33,9,25,368,0,12327,368,
rw,33,10,323,70,286,12041,356,
goni,33,10,213,180,109,12218,289,
kenett,33,10,26,367,439,11888,806,
fe,33,10,28,365,0,12327,365,
rw,33,11,333,60,309,12018,369,
goni,33,11,222,171,111,12216,282,
kenett,33,11,19,374,446,11881,820,
fe,33,11,31,362,0,12327,362,
rw,33,12,343,50,329,11998,379,
goni,33,12,245,148,128,12199,276,
kenett,33,12,21,372,444,11883,816,
fe,33,12,34,359,0,12327,359,
rw,33,13,351,42,353,11974,395,
goni,33,13,256,137,134,12193,271,
kenett,33,13,49,344,422,11905,766,
fe,33,13,37,356,0,12327,356,
rw,33,14,358,35,384,11943,419,
goni,33,14,265,128,139,12188,267,
kenett,33,14,197,196,277,12050,473,
fe,33,14,39,354,0,12327,354,
rw,33,15,363,30,411,11916,441,
goni,33,15,268,125,137,12190,262,
kenett,33,15,201,192,273,12054,465,
fe,33,15,41,352,0,12327,352,
rw,33,16,367,26,434,11893,460,
goni,33,16,280,113,146,12181,259,
kenett,33,16,220,173,254,12073,427,
fe,33,16,44,349,0,12327,349,
rw,33,17,370,23,461,11866,484,
goni,33,17,290,103,150,12177,253,
kenett,33,17,216,177,258,12069,435,
fe,33,17,46,347,0,12327,347,
rw,33,18,376,17,483,11844,500,
goni,33,18,300,93,163,12164,256,
kenett,33,18,225,168,249,12078,417,
fe,33,18,48,345,0,12327,345,
rw,33,19,378,15,501,11826,516,
goni,33,19,317,76,170,12157,246,
kenett,33,19,224,169,250,12077,419,
fe,33,19,51,342,0,12327,342,
rw,33,20,379,14,526,11801,540,
goni,33,20,323,70,179,12148,249,
kenett,33,20,221,172,253,12074,425,
fe,33,20,54,339,0,12327,339,
rw,33,21,382,11,551,11776,562,
goni,33,21,329,64,194,12133,258,
kenett,33,21,228,165,246,12081,411,
fe,33,21,57,336,0,12327,336,
rw,33,22,383,10,567,11760,577,
goni,33,22,334,59,204,12123,263,
kenett,33,22,225,168,249,12078,417,
fe,33,22,59,334,0,12327,334,
rw,33,23,384,9,584,11743,593,
goni,33,23,336,57,211,12116,268,
kenett,33,23,233,160,241,12086,401,
fe,33,23,62,331,0,12327,331,
rw,33,24,384,9,601,11726,610,
goni,33,24,339,54,215,12112,269,
kenett,33,24,238,155,236,12091,391,
fe,33,24,65,328,0,12327,328,
rw,33,25,386,7,622,11705,629,
goni,33,25,347,46,231,12096,277,
kenett,33,25,251,142,223,12104,365,
fe,33,25,67,326,0,12327,326,
rw,33,26,387,6,642,11685,648,
goni,33,26,346,47,232,12095,279,
kenett,33,26,251,142,223,12104,365,
fe,33,26,70,323,0,12327,323,
rw,33,27,387,6,668,11659,674,
goni,33,27,350,43,237,12090,280,
kenett,33,27,243,150,231,12096,381,
fe,33,27,73,320,0,12327,320,
rw,33,28,387,6,689,11638,695,
goni,33,28,357,36,250,12077,286,
kenett,33,28,251,142,223,12104,365,
fe,33,28,76,317,0,12327,317,
rw,33,29,390,3,704,11623,707,
goni,33,29,356,37,258,12069,295,
kenett,33,29,251,142,223,12104,365,
fe,33,29,78,315,0,12327,315,
rw,33,30,391,2,726,11601,728,
goni,33,30,358,35,275,12052,310,
kenett,33,30,254,139,220,12107,359,
fe,33,30,80,313,0,12327,313,
rw,33,31,391,2,748,11579,750,
goni,33,31,362,31,283,12044,314,
kenett,33,31,260,133,214,12113,347,
fe,33,31,83,310,0,12327,310,
rw,33,32,391,2,768,11559,770,
goni,33,32,361,32,279,12048,311,
kenett,33,32,262,131,212,12115,343,
fe,33,32,86,307,0,12327,307,
rw,33,33,391,2,783,11544,785,
goni,33,33,362,31,287,12040,318,
kenett,33,33,268,125,206,12121,331,
fe,33,33,89,304,0,12327,304,
rw,33,34,392,1,803,11524,804,
goni,33,34,363,30,294,12033,324,
kenett,33,34,267,126,207,12120,333,
fe,33,34,91,302,0,12327,302,
rw,33,35,392,1,823,11504,824,
goni,33,35,365,28,302,12025,330,
kenett,33,35,264,129,210,12117,339,
fe,33,35,93,300,0,12327,300,
rw,33,36,392,1,846,11481,847,
goni,33,36,366,27,311,12016,338,
kenett,33,36,262,131,212,12115,343,
fe,33,36,94,299,0,12327,299,
rw,33,37,393,0,855,11472,855,
goni,33,37,369,24,313,12014,337,
kenett,33,37,269,124,205,12122,329,
fe,33,37,97,296,0,12327,296,
rw,33,38,393,0,875,11452,875,
goni,33,38,372,21,317,12010,338,
kenett,33,38,275,118,199,12128,317,
fe,33,38,100,293,0,12327,293,
rw,33,39,393,0,892,11435,892,
goni,33,39,375,18,322,12005,340,
kenett,33,39,275,118,199,12128,317,
fe,33,39,102,291,0,12327,291,
rw,33,40,393,0,907,11420,907,
goni,33,40,377,16,330,11997,346,
kenett,33,40,275,118,199,12128,317,
fe,33,40,105,288,0,12327,288,
rw,33,41,393,0,925,11402,925,
goni,33,41,381,12,337,11990,349,
kenett,33,41,283,110,191,12136,301,
fe,33,41,106,287,0,12327,287,
rw,33,42,393,0,942,11385,942,
goni,33,42,381,12,350,11977,362,
kenett,33,42,274,119,200,12127,319,
fe,33,42,107,286,0,12327,286,
rw,33,43,393,0,961,11366,961,
goni,33,43,382,11,365,11962,376,
kenett,33,43,271,122,203,12124,325,
fe,33,43,109,284,0,12327,284,
rw,33,44,393,0,979,11348,979,
goni,33,44,381,12,370,11957,382,
kenett,33,44,272,121,202,12125,323,
fe,33,44,111,282,0,12327,282,
rw,33,45,393,0,991,11336,991,
goni,33,45,382,11,379,11948,390,
kenett,33,45,273,120,201,12126,321,
fe,33,45,112,281,0,12327,281,
rw,33,46,393,0,1004,11323,1004,
goni,33,46,381,12,397,11930,409,
kenett,33,46,275,118,199,12128,317,
fe,33,46,114,279,0,12327,279,
rw,33,47,393,0,1017,11310,1017,
goni,33,47,382,11,395,11932,406,
kenett,33,47,278,115,196,12131,311,
fe,33,47,117,276,0,12327,276,
rw,33,48,393,0,1032,11295,1032,
goni,33,48,382,11,401,11926,412,
kenett,33,48,276,117,198,12129,315,
fe,33,48,119,274,0,12327,274,
rw,33,49,393,0,1050,11277,1050,
goni,33,49,383,10,407,11920,417,
kenett,33,49,273,120,201,12126,321,
fe,33,49,121,272,0,12327,272,
rw,33,50,393,0,1071,11256,1071,
goni,33,50,383,10,406,11921,416,
kenett,33,50,273,120,201,12126,321,
fe,33,50,122,271,0,12327,271,
rw,34,1,62,331,38,12289,369,
goni,34,1,8,385,2,12325,387,
kenett,34,1,11,382,208,12119,590,
fe,34,1,3,390,0,12327,390,
rw,34,2,119,274,72,12255,346,
goni,34,2,25,368,6,12321,374,
kenett,34,2,10,383,332,11995,715,
fe,34,2,6,387,0,12327,387,
rw,34,3,158,235,107,12220,342,
goni,34,3,58,335,15,12312,350,
kenett,34,3,10,383,395,11932,778,
fe,34,3,9,384,0,12327,384,
rw,34,4,194,199,129,12198,328,
goni,34,4,90,303,26,12301,329,
kenett,34,4,9,384,417,11910,801,
fe,34,4,12,381,0,12327,381,
rw,34,5,224,169,157,12170,326,
goni,34,5,122,271,39,12288,310,
kenett,34,5,12,381,432,11895,813,
fe,34,5,15,378,0,12327,378,
rw,34,6,259,134,190,12137,324,
goni,34,6,144,249,46,12281,295,
kenett,34,6,18,375,441,11886,816,
fe,34,6,18,375,0,12327,375,
rw,34,7,277,116,225,12102,341,
goni,34,7,166,227,56,12271,283,
kenett,34,7,18,375,441,11886,816,
fe,34,7,21,372,0,12327,372,
rw,34,8,297,96,244,12083,340,
goni,34,8,178,215,65,12262,280,
kenett,34,8,15,378,453,11874,831,
fe,34,8,24,369,0,12327,369,
rw,34,9,316,77,269,12058,346,
goni,34,9,197,196,84,12243,280,
kenett,34,9,21,372,450,11877,822,
fe,34,9,26,367,0,12327,367,
rw,34,10,328,65,298,12029,363,
goni,34,10,220,173,106,12221,279,
kenett,34,10,182,211,292,12035,503,
fe,34,10,29,364,0,12327,364,
rw,34,11,337,56,324,12003,380,
goni,34,11,237,156,109,12218,265,
kenett,34,11,187,206,287,12040,493,
fe,34,11,31,362,0,12327,362,
rw,34,12,342,51,347,11980,398,
goni,34,12,263,130,122,12205,252,
kenett,34,12,200,193,274,12053,467,
fe,34,12,33,360,0,12327,360,
rw,34,13,346,47,375,11952,422,
goni,34,13,275,118,140,12187,258,
kenett,34,13,195,198,279,12048,477,
fe,34,13,35,358,0,12327,358,
rw,34,14,356,37,397,11930,434,
goni,34,14,291,102,158,12169,260,
kenett,34,14,206,187,268,12059,455,
fe,34,14,36,357,0,12327,357,
rw,34,15,360,33,417,11910,450,
goni,34,15,294,99,171,12156,270,
kenett,34,15,210,183,264,12063,447,
fe,34,15,39,354,0,12327,354,
rw,34,16,365,28,449,11878,477,
goni,34,16,307,86,182,12145,268,
kenett,34,16,217,176,257,12070,433,
fe,34,16,42,351,0,12327,351,
rw,34,17,367,26,479,11848,505,
goni,34,17,309,84,189,12138,273,
kenett,34,17,218,175,256,12071,431,
fe,34,17,45,348,0,12327,348,
rw,34,18,369,24,508,11819,532,
goni,34,18,315,78,199,12128,277,
kenett,34,18,225,168,249,12078,417,
fe,34,18,46,347,0,12327,347,
rw,34,19,373,20,531,11796,551,
goni,34,19,320,73,202,12125,275,
kenett,34,19,218,175,256,12071,431,
fe,34,19,49,344,0,12327,344,
rw,34,20,376,17,556,11771,573,
goni,34,20,323,70,216,12111,286,
kenett,34,20,234,159,240,12087,399,
fe,34,20,52,341,0,12327,341,
rw,34,21,377,16,580,11747,596,
goni,34,21,331,62,223,12104,285,
kenett,34,21,233,160,241,12086,401,
fe,34,21,55,338,0,12327,338,
rw,34,22,379,14,606,11721,620,
goni,34,22,333,60,238,12089,298,
kenett,34,22,238,155,236,12091,391,
fe,34,22,57,336,0,12327,336,
rw,34,23,379,14,629,11698,643,
goni,34,23,332,61,245,12082,306,
kenett,34,23,243,150,231,12096,381,
fe,34,23,59,334,0,12327,334,
rw,34,24,380,13,646,11681,659,
goni,34,24,335,58,259,12068,317,
kenett,34,24,241,152,233,12094,385,
fe,34,24,62,331,0,12327,331,
rw,34,25,383,10,666,11661,676,
goni,34,25,340,53,261,12066,314,
kenett,34,25,242,151,232,12095,383,
fe,34,25,64,329,0,12327,329,
rw,34,26,385,8,689,11638,697,
goni,34,26,340,53,270,12057,323,
kenett,34,26,242,151,232,12095,383,
fe,34,26,66,327,0,12327,327,
rw,34,27,385,8,709,11618,717,
goni,34,27,345,48,270,12057,318,
kenett,34,27,244,149,230,12097,379,
fe,34,27,69,324,0,12327,324,
rw,34,28,386,7,724,11603,731,
goni,34,28,346,47,281,12046,328,
kenett,34,28,254,139,220,12107,359,
fe,34,28,72,321,0,12327,321,
rw,34,29,387,6,742,11585,748,
goni,34,29,348,45,291,12036,336,
kenett,34,29,250,143,224,12103,367,
fe,34,29,73,320,0,12327,320,
rw,34,30,389,4,764,11563,768,
goni,34,30,352,41,300,12027,341,
kenett,34,30,246,147,228,12099,375,
fe,34,30,76,317,0,12327,317,
rw,34,31,389,4,785,11542,789,
goni,34,31,354,39,308,12019,347,
kenett,34,31,249,144,225,12102,369,
fe,34,31,78,315,0,12327,315,
rw,34,32,389,4,806,11521,810,
goni,34,32,360,33,315,12012,348,
kenett,34,32,258,135,216,12111,351,
fe,34,32,80,313,0,12327,313,
rw,34,33,389,4,818,11509,822,
goni,34,33,361,32,317,12010,349,
kenett,34,33,260,133,214,12113,347,
fe,34,33,83,310,0,12327,310,
rw,34,34,389,4,838,11489,842,
goni,34,34,363,30,324,12003,354,
kenett,34,34,258,135,216,12111,351,
fe,34,34,86,307,0,12327,307,
rw,34,35,390,3,856,11471,859,
goni,34,35,366,27,342,11985,369,
kenett,34,35,266,127,208,12119,335,
fe,34,35,89,304,0,12327,304,
rw,34,36,390,3,871,11456,874,
goni,34,36,368,25,345,11982,370,
kenett,34,36,268,125,206,12121,331,
fe,34,36,90,303,0,12327,303,
rw,34,37,391,2,892,11435,894,
goni,34,37,366,27,350,11977,377,
kenett,34,37,264,129,210,12117,339,
fe,34,37,92,301,0,12327,301,
rw,34,38,392,1,906,11421,907,
goni,34,38,367,26,369,11958,395,
kenett,34,38,268,125,206,12121,331,
fe,34,38,94,299,0,12327,299,
rw,34,39,392,1,920,11407,921,
goni,34,39,369,24,365,11962,389,
kenett,34,39,271,122,203,12124,325,
fe,34,39,94,299,0,12327,299,
rw,34,40,392,1,939,11388,940,
goni,34,40,367,26,371,11956,397,
kenett,34,40,268,125,206,12121,331,
fe,34,40,97,296,0,12327,296,
rw,34,41,392,1,954,11373,955,
goni,34,41,367,26,377,11950,403,
kenett,34,41,265,128,209,12118,337,
fe,34,41,100,293,0,12327,293,
rw,34,42,392,1,975,11352,976,
goni,34,42,370,23,385,11942,408,
kenett,34,42,265,128,209,12118,337,
fe,34,42,102,291,0,12327,291,
rw,34,43,392,1,986,11341,987,
goni,34,43,374,19,391,11936,410,
kenett,34,43,261,132,213,12114,345,
fe,34,43,103,290,0,12327,290,
rw,34,44,392,1,1007,11320,1008,
goni,34,44,373,20,390,11937,410,
kenett,34,44,262,131,212,12115,343,
fe,34,44,106,287,0,12327,287,
rw,34,45,392,1,1021,11306,1022,
goni,34,45,371,22,404,11923,426,
kenett,34,45,267,126,207,12120,333,
fe,34,45,108,285,0,12327,285,
rw,34,46,392,1,1039,11288,1040,
goni,34,46,373,20,409,11918,429,
kenett,34,46,267,126,207,12120,333,
fe,34,46,109,284,0,12327,284,
rw,34,47,392,1,1058,11269,1059,
goni,34,47,375,18,417,11910,435,
kenett,34,47,266,127,208,12119,335,
fe,34,47,112,281,0,12327,281,
rw,34,48,393,0,1070,11257,1070,
goni,34,48,377,16,422,11905,438,
kenett,34,48,267,126,207,12120,333,
fe,34,48,114,279,0,12327,279,
rw,34,49,393,0,1082,11245,1082,
goni,34,49,378,15,431,11896,446,
kenett,34,49,270,123,204,12123,327,
fe,34,49,116,277,0,12327,277,
rw,34,50,393,0,1098,11229,1098,
goni,34,50,378,15,428,11899,443,
kenett,34,50,267,126,207,12120,333,
fe,34,50,119,274,0,12327,274,
rw,35,1,67,326,32,12295,358,
goni,35,1,3,390,2,12325,392,
kenett,35,1,9,384,237,12090,621,
fe,35,1,3,390,0,12327,390,
rw,35,2,123,270,61,12266,331,
goni,35,2,32,361,6,12321,367,
kenett,35,2,14,379,340,11987,719,
fe,35,2,6,387,0,12327,387,
rw,35,3,171,222,84,12243,306,
goni,35,3,62,331,19,12308,350,
kenett,35,3,20,373,358,11969,731,
fe,35,3,9,384,0,12327,384,
rw,35,4,208,185,114,12213,299,
goni,35,4,97,296,29,12298,325,
kenett,35,4,21,372,408,11919,780,
fe,35,4,12,381,0,12327,381,
rw,35,5,254,139,137,12190,276,
goni,35,5,126,267,39,12288,306,
kenett,35,5,21,372,426,11901,798,
fe,35,5,15,378,0,12327,378,
rw,35,6,281,112,163,12164,275,
goni,35,6,152,241,50,12277,291,
kenett,35,6,20,373,430,11897,803,
fe,35,6,18,375,0,12327,375,
rw,35,7,300,93,193,12134,286,
goni,35,7,181,212,65,12262,277,
kenett,35,7,20,373,436,11891,809,
fe,35,7,21,372,0,12327,372,
rw,35,8,310,83,221,12106,304,
goni,35,8,204,189,77,12250,266,
kenett,35,8,17,376,442,11885,818,
fe,35,8,24,369,0,12327,369,
rw,35,9,324,69,250,12077,319,
goni,35,9,214,179,91,12236,270,
kenett,35,9,15,378,447,11880,825,
fe,35,9,27,366,0,12327,366,
rw,35,10,339,54,272,12055,326,
goni,35,10,238,155,99,12228,254,
kenett,35,10,23,370,445,11882,815,
fe,35,10,29,364,0,12327,364,
rw,35,11,348,45,297,12030,342,
goni,35,11,252,141,104,12223,245,
kenett,35,11,32,361,436,11891,797,
fe,35,11,32,361,0,12327,361,
rw,35,12,352,41,322,12005,363,
goni,35,12,260,133,126,12201,259,
kenett,35,12,20,373,448,11879,821,
fe,35,12,35,358,0,12327,358,
rw,35,13,358,35,346,11981,381,
goni,35,13,265,128,136,12191,264,
kenett,35,13,24,369,444,11883,813,
fe,35,13,38,355,0,12327,355,
rw,35,14,363,30,378,11949,408,
goni,35,14,275,118,142,12185,260,
kenett,35,14,23,370,448,11879,818,
fe,35,14,41,352,0,12327,352,
rw,35,15,369,24,404,11923,428,
goni,35,15,287,106,145,12182,251,
kenett,35,15,25,368,446,11881,814,
fe,35,15,44,349,0,12327,349,
rw,35,16,371,22,426,11901,448,
goni,35,16,297,96,148,12179,244,
kenett,35,16,30,363,441,11886,804,
fe,35,16,46,347,0,12327,347,
rw,35,17,375,18,453,11874,471,
goni,35,17,303,90,160,12167,250,
kenett,35,17,193,200,281,12046,481,
fe,35,17,48,345,0,12327,345,
rw,35,18,378,15,475,11852,490,
goni,35,18,310,83,173,12154,256,
kenett,35,18,202,191,272,12055,463,
fe,35,18,51,342,0,12327,342,
rw,35,19,381,12,495,11832,507,
goni,35,19,314,79,183,12144,262,
kenett,35,19,210,183,264,12063,447,
fe,35,19,54,339,0,12327,339,
rw,35,20,384,9,517,11810,526,
goni,35,20,324,69,188,12139,257,
kenett,35,20,207,186,267,12060,453,
fe,35,20,57,336,0,12327,336,
rw,35,21,384,9,541,11786,550,
goni,35,21,330,63,204,12123,267,
kenett,35,21,225,168,249,12078,417,
fe,35,21,58,335,0,12327,335,
rw,35,22,386,7,571,11756,578,
goni,35,22,335,58,205,12122,263,
kenett,35,22,224,169,250,12077,419,
fe,35,22,61,332,0,12327,332,
rw,35,23,386,7,589,11738,596,
goni,35,23,340,53,215,12112,268,
kenett,35,23,225,168,249,12078,417,
fe,35,23,63,330,0,12327,330,
rw,35,24,387,6,601,11726,607,
goni,35,24,350,43,222,12105,265,
kenett,35,24,227,166,247,12080,413,
fe,35,24,66,327,0,12327,327,
rw,35,25,388,5,631,11696,636,
goni,35,25,344,49,229,12098,278,
kenett,35,25,229,164,245,12082,409,
fe,35,25,69,324,0,12327,324,
rw,35,26,388,5,648,11679,653,
goni,35,26,352,41,236,12091,277,
kenett,35,26,235,158,239,12088,397,
fe,35,26,71,322,0,12327,322,
rw,35,27,388,5,670,11657,675,
goni,35,27,356,37,244,12083,281,
kenett,35,27,241,152,233,12094,385,
fe,35,27,74,319,0,12327,319,
rw,35,28,388,5,684,11643,689,
goni,35,28,358,35,256,12071,291,
kenett,35,28,230,163,244,12083,407,
fe,35,28,77,316,0,12327,316,
rw,35,29,388,5,704,11623,709,
goni,35,29,365,28,268,12059,296,
kenett,35,29,228,165,246,12081,411,
fe,35,29,78,315,0,12327,315,
rw,35,30,390,3,727,11600,730,
goni,35,30,369,24,272,12055,296,
kenett,35,30,247,146,227,12100,373,
fe,35,30,81,312,0,12327,312,
rw,35,31,390,3,747,11580,750,
goni,35,31,368,25,281,12046,306,
kenett,35,31,252,141,222,12105,363,
fe,35,31,84,309,0,12327,309,
rw,35,32,390,3,767,11560,770,
goni,35,32,368,25,296,12031,321,
kenett,35,32,247,146,227,12100,373,
fe,35,32,86,307,0,12327,307,
rw,35,33,391,2,784,11543,786,
goni,35,33,369,24,302,12025,326,
kenett,35,33,255,138,219,12108,357,
fe,35,33,88,305,0,12327,305,
rw,35,34,391,2,799,11528,801,
goni,35,34,372,21,301,12026,322,
kenett,35,34,260,133,214,12113,347,
fe,35,34,90,303,0,12327,303,
rw,35,35,392,1,812,11515,813,
goni,35,35,372,21,308,12019,329,
kenett,35,35,267,126,207,12120,333,
fe,35,35,91,302,0,12327,302,
rw,35,36,392,1,834,11493,835,
goni,35,36,372,21,308,12019,329,
kenett,35,36,267,126,207,12120,333,
fe,35,36,93,300,0,12327,300,
rw,35,37,392,1,854,11473,855,
goni,35,37,374,19,315,12012,334,
kenett,35,37,259,134,215,12112,349,
fe,35,37,95,298,0,12327,298,
rw,35,38,392,1,871,11456,872,
goni,35,38,376,17,328,11999,345,
kenett,35,38,263,130,211,12116,341,
fe,35,38,98,295,0,12327,295,
rw,35,39,392,1,890,11437,891,
goni,35,39,377,16,334,11993,350,
kenett,35,39,270,123,204,12123,327,
fe,35,39,100,293,0,12327,293,
rw,35,40,392,1,908,11419,909,
goni,35,40,377,16,339,11988,355,
kenett,35,40,265,128,209,12118,337,
fe,35,40,100,293,0,12327,293,
rw,35,41,392,1,926,11401,927,
goni,35,41,377,16,349,11978,365,
kenett,35,41,264,129,210,12117,339,
fe,35,41,100,293,0,12327,293,
rw,35,42,392,1,947,11380,948,
goni,35,42,377,16,354,11973,370,
kenett,35,42,266,127,208,12119,335,
fe,35,42,102,291,0,12327,291,
rw,35,43,392,1,968,11359,969,
goni,35,43,377,16,357,11970,373,
kenett,35,43,276,117,198,12129,315,
fe,35,43,103,290,0,12327,290,
rw,35,44,393,0,991,11336,991,
goni,35,44,377,16,363,11964,379,
kenett,35,44,274,119,200,12127,319,
fe,35,44,106,287,0,12327,287,
rw,35,45,393,0,1004,11323,1004,
goni,35,45,377,16,373,11954,389,
kenett,35,45,264,129,210,12117,339,
fe,35,45,108,285,0,12327,285,
rw,35,46,393,0,1012,11315,1012,
goni,35,46,377,16,377,11950,393,
kenett,35,46,266,127,208,12119,335,
fe,35,46,111,282,0,12327,282,
rw,35,47,393,0,1033,11294,1033,
goni,35,47,377,16,381,11946,397,
kenett,35,47,269,124,205,12122,329,
fe,35,47,114,279,0,12327,279,
rw,35,48,393,0,1050,11277,1050,
goni,35,48,377,16,385,11942,401,
kenett,35,48,268,125,206,12121,331,
fe,35,48,115,278,0,12327,278,
rw,35,49,393,0,1069,11258,1069,
goni,35,49,378,15,389,11938,404,
kenett,35,49,275,118,199,12128,317,
fe,35,49,116,277,0,12327,277,
rw,35,50,393,0,1080,11247,1080,
goni,35,50,378,15,392,11935,407,
kenett,35,50,268,125,206,12121,331,
fe,35,50,119,274,0,12327,274,
rw,36,1,56,337,43,12284,380,
goni,36,1,4,389,3,12324,392,
kenett,36,1,5,388,214,12113,602,
fe,36,1,3,390,0,12327,390,
rw,36,2,116,277,76,12251,353,
goni,36,2,20,373,8,12319,381,
kenett,36,2,11,382,355,11972,737,
fe,36,2,6,387,0,12327,387,
rw,36,3,160,233,111,12216,344,
goni,36,3,50,343,19,12308,362,
kenett,36,3,13,380,389,11938,769,
fe,36,3,9,384,0,12327,384,
rw,36,4,195,198,141,12186,339,
goni,36,4,91,302,36,12291,338,
kenett,36,4,17,376,394,11933,770,
fe,36,4,12,381,0,12327,381,
rw,36,5,228,165,168,12159,333,
goni,36,5,123,270,47,12280,317,
kenett,36,5,13,380,413,11914,793,
fe,36,5,15,378,0,12327,378,
rw,36,6,257,136,192,12135,328,
goni,36,6,146,247,55,12272,302,
kenett,36,6,17,376,424,11903,800,
fe,36,6,18,375,0,12327,375,
rw,36,7,279,114,219,12108,333,
goni,36,7,169,224,65,12262,289,
kenett,36,7,23,370,430,11897,800,
fe,36,7,21,372,0,12327,372,
rw,36,8,290,103,246,12081,349,
goni,36,8,186,207,72,12255,279,
kenett,36,8,17,376,442,11885,818,
fe,36,8,24,369,0,12327,369,
rw,36,9,300,93,279,12048,372,
goni,36,9,207,186,85,12242,271,
kenett,36,9,15,378,444,11883,822,
fe,36,9,25,368,0,12327,368,
rw,36,10,317,76,313,12014,389,
goni,36,10,218,175,102,12225,277,
kenett,36,10,22,371,443,11884,814,
fe,36,10,28,365,0,12327,365,
rw,36,11,327,66,342,11985,408,
goni,36,11,234,159,104,12223,263,
kenett,36,11,20,373,445,11882,818,
fe,36,11,31,362,0,12327,362,
rw,36,12,337,56,372,11955,428,
goni,36,12,247,146,121,12206,267,
kenett,36,12,29,364,439,11888,803,
fe,36,12,34,359,0,12327,359,
rw,36,13,349,44,394,11933,438,
goni,36,13,267,126,137,12190,263,
kenett,36,13,24,369,444,11883,813,
fe,36,13,37,356,0,12327,356,
rw,36,14,355,38,419,11908,457,
goni,36,14,276,117,149,12178,266,
kenett,36,14,27,366,444,11883,810,
fe,36,14,39,354,0,12327,354,
rw,36,15,362,31,442,11885,473,
goni,36,15,287,106,151,12176,257,
kenett,36,15,190,203,284,12043,487,
fe,36,15,42,351,0,12327,351,
rw,36,16,367,26,464,11863,490,
goni,36,16,292,101,165,12162,266,
kenett,36,16,204,189,270,12057,459,
fe,36,16,45,348,0,12327,348,
rw,36,17,370,23,492,11835,515,
goni,36,17,299,94,173,12154,267,
kenett,36,17,204,189,270,12057,459,
fe,36,17,47,346,0,12327,346,
rw,36,18,375,18,510,11817,528,
goni,36,18,311,82,175,12152,257,
kenett,36,18,212,181,262,12065,443,
fe,36,18,49,344,0,12327,344,
rw,36,19,376,17,538,11789,555,
goni,36,19,312,81,192,12135,273,
kenett,36,19,214,179,260,12067,439,
fe,36,19,51,342,0,12327,342,
rw,36,20,377,16,559,11768,575,
goni,36,20,314,79,196,12131,275,
kenett,36,20,219,174,255,12072,429,
fe,36,20,54,339,0,12327,339,
rw,36,21,380,13,577,11750,590,
goni,36,21,322,71,212,12115,283,
kenett,36,21,228,165,246,12081,411,
fe,36,21,56,337,0,12327,337,
rw,36,22,382,11,598,11729,609,
goni,36,22,331,62,224,12103,286,
kenett,36,22,233,160,241,12086,401,
fe,36,22,58,335,0,12327,335,
rw,36,23,383,10,625,11702,635,
goni,36,23,337,56,225,12102,281,
kenett,36,23,228,165,246,12081,411,
fe,36,23,61,332,0,12327,332,
rw,36,24,385,8,641,11686,649,
goni,36,24,340,53,228,12099,281,
kenett,36,24,235,158,239,12088,397,
fe,36,24,63,330,0,12327,330,
rw,36,25,385,8,668,11659,676,
goni,36,25,341,52,239,12088,291,
kenett,36,25,235,158,239,12088,397,
fe,36,25,65,328,0,12327,328,
rw,36,26,387,6,694,11633,700,
goni,36,26,347,46,248,12079,294,
kenett,36,26,253,140,221,12106,361,
fe,36,26,68,325,0,12327,325,
rw,36,27,388,5,712,11615,717,
goni,36,27,354,39,250,12077,289,
kenett,36,27,244,149,230,12097,379,
fe,36,27,71,322,0,12327,322,
rw,36,28,388,5,730,11597,735,
goni,36,28,356,37,254,12073,291,
kenett,36,28,243,150,231,12096,381,
fe,36,28,73,320,0,12327,320,
rw,36,29,388,5,753,11574,758,
goni,36,29,360,33,257,12070,290,
kenett,36,29,258,135,216,12111,351,
fe,36,29,76,317,0,12327,317,
rw,36,30,389,4,770,11557,774,
goni,36,30,364,29,271,12056,300,
kenett,36,30,244,149,230,12097,379,
fe,36,30,78,315,0,12327,315,
rw,36,31,389,4,792,11535,796,
goni,36,31,361,32,273,12054,305,
kenett,36,31,254,139,220,12107,359,
fe,36,31,79,314,0,12327,314,
rw,36,32,389,4,813,11514,817,
goni,36,32,363,30,274,12053,304,
kenett,36,32,256,137,218,12109,355,
fe,36,32,82,311,0,12327,311,
rw,36,33,390,3,834,11493,837,
goni,36,33,367,26,288,12039,314,
kenett,36,33,255,138,219,12108,357,
fe,36,33,85,308,0,12327,308,
rw,36,34,391,2,849,11478,851,
goni,36,34,366,27,293,12034,320,
kenett,36,34,255,138,219,12108,357,
fe,36,34,86,307,0,12327,307,
rw,36,35,391,2,870,11457,872,
goni,36,35,369,24,298,12029,322,
kenett,36,35,259,134,215,12112,349,
fe,36,35,87,306,0,12327,306,
rw,36,36,391,2,884,11443,886,
goni,36,36,369,24,304,12023,328,
kenett,36,36,265,128,209,12118,337,
fe,36,36,89,304,0,12327,304,
rw,36,37,391,2,905,11422,907,
goni,36,37,369,24,310,12017,334,
kenett,36,37,261,132,213,12114,345,
fe,36,37,90,303,0,12327,303,
rw,36,38,393,0,927,11400,927,
goni,36,38,372,21,310,12017,331,
kenett,36,38,266,127,208,12119,335,
fe,36,38,93,300,0,12327,300,
rw,36,39,393,0,940,11387,940,
goni,36,39,375,18,314,12013,332,
kenett,36,39,260,133,214,12113,347,
fe,36,39,96,297,0,12327,297,
rw,36,40,393,0,956,11371,956,
goni,36,40,377,16,321,12006,337,
kenett,36,40,264,129,210,12117,339,
fe,36,40,98,295,0,12327,295,
rw,36,41,393,0,974,11353,974,
goni,36,41,378,15,321,12006,336,
kenett,36,41,266,127,208,12119,335,
fe,36,41,100,293,0,12327,293,
rw,36,42,393,0,993,11334,993,
goni,36,42,379,14,321,12006,335,
kenett,36,42,265,128,209,12118,337,
fe,36,42,103,290,0,12327,290,
rw,36,43,393,0,1010,11317,1010,
goni,36,43,379,14,331,11996,345,
kenett,36,43,264,129,210,12117,339,
fe,36,43,106,287,0,12327,287,
rw,36,44,393,0,1030,11297,1030,
goni,36,44,379,14,345,11982,359,
kenett,36,44,266,127,208,12119,335,
fe,36,44,108,285,0,12327,285,
rw,36,45,393,0,1055,11272,1055,
goni,36,45,383,10,356,11971,366,
kenett,36,45,273,120,201,12126,321,
fe,36,45,111,282,0,12327,282,
rw,36,46,393,0,1074,11253,1074,
goni,36,46,383,10,373,11954,383,
kenett,36,46,269,124,205,12122,329,
fe,36,46,113,280,0,12327,280,
rw,36,47,393,0,1090,11237,1090,
goni,36,47,383,10,381,11946,391,
kenett,36,47,271,122,203,12124,325,
fe,36,47,115,278,0,12327,278,
rw,36,48,393,0,1107,11220,1107,
goni,36,48,381,12,386,11941,398,
kenett,36,48,272,121,202,12125,323,
fe,36,48,117,276,0,12327,276,
rw,36,49,393,0,1122,11205,1122,
goni,36,49,381,12,389,11938,401,
kenett,36,49,278,115,196,12131,311,
fe,36,49,120,273,0,12327,273,
rw,36,50,393,0,1136,11191,1136,
goni,36,50,383,10,401,11926,411,
kenett,36,50,282,111,192,12135,303,
fe,36,50,122,271,0,12327,271,
rw,37,1,63,330,31,12296,361,
goni,37,1,10,383,4,12323,387,
kenett,37,1,13,380,179,12148,559,
fe,37,1,3,390,0,12327,390,
rw,37,2,122,271,54,12273,325,
goni,37,2,41,352,10,12317,362,
kenett,37,2,15,378,291,12036,669,
fe,37,2,6,387,0,12327,387,
rw,37,3,165,228,88,12239,316,
goni,37,3,64,329,18,12309,347,
kenett,37,3,16,377,359,11968,736,
fe,37,3,9,384,0,12327,384,
rw,37,4,197,196,122,12205,318,
goni,37,4,90,303,28,12299,331,
kenett,37,4,13,380,389,11938,769,
fe,37,4,12,381,0,12327,381,
rw,37,5,228,165,145,12182,310,
goni,37,5,118,275,37,12290,312,
kenett,37,5,19,374,401,11926,775,
fe,37,5,15,378,0,12327,378,
rw,37,6,254,139,179,12148,318,
goni,37,6,144,249,46,12281,295,
kenett,37,6,19,374,416,11911,790,
fe,37,6,18,375,0,12327,375,
rw,37,7,272,121,208,12119,329,
goni,37,7,173,220,62,12265,282,
kenett,37,7,16,377,422,11905,799,
fe,37,7,21,372,0,12327,372,
rw,37,8,290,103,228,12099,331,
goni,37,8,195,198,71,12256,269,
kenett,37,8,22,371,434,11893,805,
fe,37,8,24,369,0,12327,369,
rw,37,9,303,90,252,12075,342,
goni,37,9,203,190,79,12248,269,
kenett,37,9,17,376,442,11885,818,
fe,37,9,27,366,0,12327,366,
rw,37,10,314,79,272,12055,351,
goni,37,10,224,169,102,12225,271,
kenett,37,10,17,376,445,11882,821,
fe,37,10,30,363,0,12327,363,
rw,37,11,323,70,306,12021,376,
goni,37,11,238,155,110,12217,265,
kenett,37,11,17,376,448,11879,824,
fe,37,11,31,362,0,12327,362,
rw,37,12,333,60,329,11998,389,
goni,37,12,252,141,124,12203,265,
kenett,37,12,23,370,445,11882,815,
fe,37,12,34,359,0,12327,359,
rw,37,13,344,49,361,11966,410,
goni,37,13,255,138,137,12190,275,
kenett,37,13,24,369,444,11883,813,
fe,37,13,37,356,0,12327,356,
rw,37,14,351,42,383,11944,425,
goni,37,14,272,121,151,12176,272,
kenett,37,14,25,368,446,11881,814,
fe,37,14,40,353,0,12327,353,
rw,37,15,354,39,403,11924,442,
goni,37,15,286,107,153,12174,260,
kenett,37,15,20,373,451,11876,824,
fe,37,15,43,350,0,12327,350,
rw,37,16,362,31,428,11899,459,
goni,37,16,298,95,173,12154,268,
kenett,37,16,26,367,445,11882,812,
fe,37,16,46,347,0,12327,347,
rw,37,17,364,29,449,11878,478,
goni,37,17,309,84,189,12138,273,
kenett,37,17,25,368,446,11881,814,
fe,37,17,49,344,0,12327,344,
rw,37,18,370,23,477,11850,500,
goni,37,18,313,80,202,12125,282,
kenett,37,18,21,372,450,11877,822,
fe,37,18,52,341,0,12327,341,
rw,37,19,374,19,498,11829,517,
goni,37,19,323,70,218,12109,288,
kenett,37,19,16,377,455,11872,832,
fe,37,19,55,338,0,12327,338,
rw,37,20,376,17,518,11809,535,
goni,37,20,329,64,220,12107,284,
kenett,37,20,23,370,448,11879,818,
fe,37,20,58,335,0,12327,335,
rw,37,21,381,12,541,11786,553,
goni,37,21,334,59,231,12096,290,
kenett,37,21,20,373,451,11876,824,
fe,37,21,61,332,0,12327,332,
rw,37,22,382,11,569,11758,580,
goni,37,22,339,54,230,12097,284,
kenett,37,22,25,368,446,11881,814,
fe,37,22,64,329,0,12327,329,
rw,37,23,384,9,589,11738,598,
goni,37,23,341,52,240,12087,292,
kenett,37,23,23,370,448,11879,818,
fe,37,23,67,326,0,12327,326,
rw,37,24,385,8,614,11713,622,
goni,37,24,343,50,238,12089,288,
kenett,37,24,229,164,245,12082,409,
fe,37,24,70,323,0,12327,323,
rw,37,25,386,7,637,11690,644,
goni,37,25,345,48,240,12087,288,
kenett,37,25,236,157,238,12089,395,
fe,37,25,72,321,0,12327,321,
rw,37,26,386,7,660,11667,667,
goni,37,26,347,46,250,12077,296,
kenett,37,26,242,151,232,12095,383,
fe,37,26,74,319,0,12327,319,
rw,37,27,387,6,680,11647,686,
goni,37,27,345,48,268,12059,316,
kenett,37,27,245,148,229,12098,377,
fe,37,27,76,317,0,12327,317,
rw,37,28,388,5,699,11628,704,
goni,37,28,354,39,281,12046,320,
kenett,37,28,243,150,231,12096,381,
fe,37,28,78,315,0,12327,315,
rw,37,29,389,4,712,11615,716,
goni,37,29,355,38,282,12045,320,
kenett,37,29,247,146,227,12100,373,
fe,37,29,80,313,0,12327,313,
rw,37,30,390,3,735,11592,738,
goni,37,30,359,34,293,12034,327,
kenett,37,30,254,139,220,12107,359,
fe,37,30,83,310,0,12327,310,
rw,37,31,391,2,748,11579,750,
goni,37,31,361,32,304,12023,336,
kenett,37,31,256,137,218,12109,355,
fe,37,31,86,307,0,12327,307,
rw,37,32,391,2,768,11559,770,
goni,37,32,365,28,310,12017,338,
kenett,37,32,250,143,224,12103,367,
fe,37,32,89,304,0,12327,304,
rw,37,33,391,2,782,11545,784,
goni,37,33,361,32,320,12007,352,
kenett,37,33,255,138,219,12108,357,
fe,37,33,92,301,0,12327,301,
rw,37,34,391,2,797,11530,799,
goni,37,34,362,31,323,12004,354,
kenett,37,34,259,134,215,12112,349,
fe,37,34,95,298,0,12327,298,
rw,37,35,391,2,811,11516,813,
goni,37,35,366,27,331,11996,358,
kenett,37,35,253,140,221,12106,361,
fe,37,35,98,295,0,12327,295,
rw,37,36,391,2,829,11498,831,
goni,37,36,368,25,339,11988,364,
kenett,37,36,260,133,214,12113,347,
fe,37,36,100,293,0,12327,293,
rw,37,37,392,1,847,11480,848,
goni,37,37,371,22,340,11987,362,
kenett,37,37,259,134,215,12112,349,
fe,37,37,101,292,0,12327,292,
rw,37,38,392,1,859,11468,860,
goni,37,38,374,19,341,11986,360,
kenett,37,38,257,136,217,12110,353,
fe,37,38,102,291,0,12327,291,
rw,37,39,392,1,876,11451,877,
goni,37,39,374,19,352,11975,371,
kenett,37,39,265,128,209,12118,337,
fe,37,39,105,288,0,12327,288,
rw,37,40,392,1,891,11436,892,
goni,37,40,377,16,357,11970,373,
kenett,37,40,263,130,211,12116,341,
fe,37,40,106,287,0,12327,287,
rw,37,41,392,1,909,11418,910,
goni,37,41,376,17,363,11964,380,
kenett,37,41,265,128,209,12118,337,
fe,37,41,107,286,0,12327,286,
rw,37,42,392,1,922,11405,923,
goni,37,42,376,17,361,11966,378,
kenett,37,42,268,125,206,12121,331,
fe,37,42,108,285,0,12327,285,
rw,37,43,392,1,940,11387,941,
goni,37,43,377,16,374,11953,390,
kenett,37,43,271,122,203,12124,325,
fe,37,43,110,283,0,12327,283,
rw,37,44,392,1,965,11362,966,
goni,37,44,379,14,380,11947,394,
kenett,37,44,268,125,206,12121,331,
fe,37,44,111,282,0,12327,282,
rw,37,45,392,1,987,11340,988,
goni,37,45,379,14,391,11936,405,
kenett,37,45,269,124,205,12122,329,
fe,37,45,113,280,0,12327,280,
rw,37,46,392,1,1009,11318,1010,
goni,37,46,379,14,394,11933,408,
kenett,37,46,269,124,205,12122,329,
fe,37,46,115,278,0,12327,278,
rw,37,47,392,1,1023,11304,1024,
goni,37,47,381,12,395,11932,407,
kenett,37,47,272,121,202,12125,323,
fe,37,47,118,275,0,12327,275,
rw,37,48,392,1,1049,11278,1050,
goni,37,48,380,13,401,11926,414,
kenett,37,48,269,124,205,12122,329,
fe,37,48,119,274,0,12327,274,
rw,37,49,392,1,1067,11260,1068,
goni,37,49,381,12,402,11925,414,
kenett,37,49,272,121,202,12125,323,
fe,37,49,120,273,0,12327,273,
rw,37,50,392,1,1080,11247,1081,
goni,37,50,381,12,404,11923,416,
kenett,37,50,281,112,193,12134,305,
fe,37,50,122,271,0,12327,271,
rw,38,1,66,327,29,12298,356,
goni,38,1,7,386,0,12327,386,
kenett,38,1,9,384,210,12117,594,
fe,38,1,3,390,0,12327,390,
rw,38,2,128,265,57,12270,322,
goni,38,2,33,360,6,12321,366,
kenett,38,2,20,373,325,12002,698,
fe,38,2,6,387,0,12327,387,
rw,38,3,173,220,86,12241,306,
goni,38,3,55,338,20,12307,358,
kenett,38,3,24,369,384,11943,753,
fe,38,3,8,385,0,12327,385,
rw,38,4,214,179,111,12216,290,
goni,38,4,86,307,31,12296,338,
kenett,38,4,18,375,423,11904,798,
fe,38,4,11,382,0,12327,382,
rw,38,5,239,154,136,12191,290,
goni,38,5,129,264,44,12283,308,
kenett,38,5,17,376,430,11897,806,
fe,38,5,13,380,0,12327,380,
rw,38,6,269,124,162,12165,286,
goni,38,6,155,238,52,12275,290,
kenett,38,6,19,374,437,11890,811,
fe,38,6,15,378,0,12327,378,
rw,38,7,293,100,182,12145,282,
goni,38,7,179,214,63,12264,277,
kenett,38,7,19,374,440,11887,814,
fe,38,7,18,375,0,12327,375,
rw,38,8,309,84,210,12117,294,
goni,38,8,183,210,70,12257,280,
kenett,38,8,22,371,440,11887,811,
fe,38,8,20,373,0,12327,373,
rw,38,9,320,73,237,12090,310,
goni,38,9,210,183,80,12247,263,
kenett,38,9,27,366,444,11883,810,
fe,38,9,22,371,0,12327,371,
rw,38,10,334,59,264,12063,323,
goni,38,10,231,162,97,12230,259,
kenett,38,10,25,368,446,11881,814,
fe,38,10,25,368,0,12327,368,
rw,38,11,346,47,290,12037,337,
goni,38,11,259,134,103,12224,237,
kenett,38,11,172,221,302,12025,523,
fe,38,11,28,365,0,12327,365,
rw,38,12,359,34,321,12006,355,
goni,38,12,271,122,114,12213,236,
kenett,38,12,176,217,298,12029,515,
fe,38,12,31,362,0,12327,362,
rw,38,13,367,26,341,11986,367,
goni,38,13,296,97,125,12202,222,
kenett,38,13,191,202,283,12044,485,
fe,38,13,34,359,0,12327,359,
rw,38,14,370,23,368,11959,391,
goni,38,14,303,90,136,12191,226,
kenett,38,14,195,198,279,12048,477,
fe,38,14,36,357,0,12327,357,
rw,38,15,375,18,395,11932,413,
goni,38,15,315,78,151,12176,229,
kenett,38,15,200,193,274,12053,467,
fe,38,15,38,355,0,12327,355,
rw,38,16,377,16,423,11904,439,
goni,38,16,316,77,154,12173,231,
kenett,38,16,213,180,261,12066,441,
fe,38,16,41,352,0,12327,352,
rw,38,17,377,16,456,11871,472,
goni,38,17,322,71,158,12169,229,
kenett,38,17,222,171,252,12075,423,
fe,38,17,44,349,0,12327,349,
rw,38,18,381,12,478,11849,490,
goni,38,18,323,70,170,12157,240,
kenett,38,18,213,180,261,12066,441,
fe,38,18,47,346,0,12327,346,
rw,38,19,381,12,499,11828,511,
goni,38,19,328,65,173,12154,238,
kenett,38,19,218,175,256,12071,431,
fe,38,19,49,344,0,12327,344,
rw,38,20,382,11,519,11808,530,
goni,38,20,336,57,187,12140,244,
kenett,38,20,217,176,257,12070,433,
fe,38,20,52,341,0,12327,341,
rw,38,21,385,8,541,11786,549,
goni,38,21,340,53,195,12132,248,
kenett,38,21,227,166,247,12080,413,
fe,38,21,55,338,0,12327,338,
rw,38,22,387,6,566,11761,572,
goni,38,22,340,53,207,12120,260,
kenett,38,22,223,170,251,12076,421,
fe,38,22,57,336,0,12327,336,
rw,38,23,388,5,588,11739,593,
goni,38,23,344,49,216,12111,265,
kenett,38,23,229,164,245,12082,409,
fe,38,23,60,333,0,12327,333,
rw,38,24,389,4,609,11718,613,
goni,38,24,349,44,228,12099,272,
kenett,38,24,232,161,242,12085,403,
fe,38,24,63,330,0,12327,330,
rw,38,25,390,3,630,11697,633,
goni,38,25,355,38,228,12099,266,
kenett,38,25,251,142,223,12104,365,
fe,38,25,65,328,0,12327,328,
rw,38,26,390,3,649,11678,652,
goni,38,26,358,35,241,12086,276,
kenett,38,26,251,142,223,12104,365,
fe,38,26,68,325,0,12327,325,
rw,38,27,390,3,668,11659,671,
goni,38,27,362,31,247,12080,278,
kenett,38,27,258,135,216,12111,351,
fe,38,27,70,323,0,12327,323,
rw,38,28,390,3,690,11637,693,
goni,38,28,366,27,262,12065,289,
kenett,38,28,257,136,217,12110,353,
fe,38,28,73,320,0,12327,320,
rw,38,29,391,2,714,11613,716,
goni,38,29,367,26,261,12066,287,
kenett,38,29,265,128,209,12118,337,
fe,38,29,76,317,0,12327,317,
rw,38,30,391,2,731,11596,733,
goni,38,30,368,25,278,12049,303,
kenett,38,30,261,132,213,12114,345,
fe,38,30,78,315,0,12327,315,
rw,38,31,392,1,752,11575,753,
goni,38,31,366,27,280,12047,307,
kenett,38,31,251,142,223,12104,365,
fe,38,31,81,312,0,12327,312,
rw,38,32,392,1,768,11559,769,
goni,38,32,369,24,285,12042,309,
kenett,38,32,267,126,207,12120,333,
fe,38,32,84,309,0,12327,309,
rw,38,33,393,0,790,11537,790,
goni,38,33,368,25,286,12041,311,
kenett,38,33,259,134,215,12112,349,
fe,38,33,85,308,0,12327,308,
rw,38,34,393,0,811,11516,811,
goni,38,34,370,23,297,12030,320,
kenett,38,34,256,137,218,12109,355,
fe,38,34,87,306,0,12327,306,
rw,38,35,393,0,824,11503,824,
goni,38,35,373,20,308,12019,328,
kenett,38,35,255,138,219,12108,357,
fe,38,35,90,303,0,12327,303,
rw,38,36,393,0,843,11484,843,
goni,38,36,373,20,319,12008,339,
kenett,38,36,259,134,215,12112,349,
fe,38,36,92,301,0,12327,301,
rw,38,37,393,0,860,11467,860,
goni,38,37,374,19,326,12001,345,
kenett,38,37,265,128,209,12118,337,
fe,38,37,95,298,0,12327,298,
rw,38,38,393,0,875,11452,875,
goni,38,38,379,14,336,11991,350,
kenett,38,38,256,137,218,12109,355,
fe,38,38,97,296,0,12327,296,
rw,38,39,393,0,894,11433,894,
goni,38,39,378,15,342,11985,357,
kenett,38,39,261,132,213,12114,345,
fe,38,39,99,294,0,12327,294,
rw,38,40,393,0,909,11418,909,
goni,38,40,379,14,348,11979,362,
kenett,38,40,259,134,215,12112,349,
fe,38,40,100,293,0,12327,293,
rw,38,41,393,0,930,11397,930,
goni,38,41,380,13,360,11967,373,
kenett,38,41,260,133,214,12113,347,
fe,38,41,103,290,0,12327,290,
rw,38,42,393,0,952,11375,952,
goni,38,42,382,11,365,11962,376,
kenett,38,42,263,130,211,12116,341,
fe,38,42,104,289,0,12327,289,
rw,38,43,393,0,967,11360,967,
goni,38,43,382,11,372,11955,383,
kenett,38,43,268,125,206,12121,331,
fe,38,43,107,286,0,12327,286,
rw,38,44,393,0,978,11349,978,
goni,38,44,381,12,379,11948,391,
kenett,38,44,270,123,204,12123,327,
fe,38,44,109,284,0,12327,284,
rw,38,45,393,0,1001,11326,1001,
goni,38,45,380,13,383,11944,396,
kenett,38,45,266,127,208,12119,335,
fe,38,45,111,282,0,12327,282,
rw,38,46,393,0,1016,11311,1016,
goni,38,46,381,12,390,11937,402,
kenett,38,46,265,128,209,12118,337,
fe,38,46,113,280,0,12327,280,
rw,38,47,393,0,1032,11295,1032,
goni,38,47,380,13,390,11937,403,
kenett,38,47,262,131,212,12115,343,
fe,38,47,114,279,0,12327,279,
rw,38,48,393,0,1045,11282,1045,
goni,38,48,381,12,389,11938,401,
kenett,38,48,264,129,210,12117,339,
fe,38,48,116,277,0,12327,277,
rw,38,49,393,0,1061,11266,1061,
goni,38,49,382,11,402,11925,413,
kenett,38,49,266,127,208,12119,335,
fe,38,49,117,276,0,12327,276,
rw,38,50,393,0,1084,11243,1084,
goni,38,50,382,11,409,11918,420,
kenett,38,50,272,121,202,12125,323,
fe,38,50,120,273,0,12327,273,
rw,39,1,68,325,26,12301,351,
goni,39,1,13,380,2,12325,382,
kenett,39,1,15,378,162,12165,540,
fe,39,1,3,390,0,12327,390,
rw,39,2,118,275,67,12260,342,
goni,39,2,27,366,6,12321,372,
kenett,39,2,12,381,315,12012,696,
fe,39,2,6,387,0,12327,387,
rw,39,3,167,226,94,12233,320,
goni,39,3,57,336,16,12311,352,
kenett,39,3,19,374,383,11944,757,
fe,39,3,9,384,0,12327,384,
rw,39,4,207,186,114,12213,300,
goni,39,4,84,309,19,12308,328,
kenett,39,4,14,379,400,11927,779,
fe,39,4,12,381,0,12327,381,
rw,39,5,239,154,139,12188,293,
goni,39,5,121,272,24,12303,296,
kenett,39,5,19,374,425,11902,799,
fe,39,5,15,378,0,12327,378,
rw,39,6,267,126,169,12158,295,
goni,39,6,136,257,34,12293,291,
kenett,39,6,18,375,435,11892,810,
fe,39,6,18,375,0,12327,375,
rw,39,7,284,109,196,12131,305,
goni,39,7,159,234,50,12277,284,
kenett,39,7,16,377,443,11884,820,
fe,39,7,21,372,0,12327,372,
rw,39,8,298,95,218,12109,313,
goni,39,8,185,208,57,12270,265,
kenett,39,8,22,371,437,11890,808,
fe,39,8,24,369,0,12327,369,
rw,39,9,305,88,250,12077,338,
goni,39,9,199,194,65,12262,259,
kenett,39,9,25,368,437,11890,805,
fe,39,9,26,367,0,12327,367,
rw,39,10,314,79,283,12044,362,
goni,39,10,215,178,77,12250,255,
kenett,39,10,18,375,450,11877,825,
fe,39,10,29,364,0,12327,364,
rw,39,11,326,67,306,12021,373,
goni,39,11,236,157,90,12237,247,
kenett,39,11,17,376,451,11876,827,
fe,39,11,32,361,0,12327,361,
rw,39,12,334,59,322,12005,381,
goni,39,12,251,142,97,12230,239,
kenett,39,12,16,377,452,11875,829,
fe,39,12,34,359,0,12327,359,
rw,39,13,344,49,341,11986,390,
goni,39,13,262,131,100,12227,231,
kenett,39,13,12,381,456,11871,837,
fe,39,13,37,356,0,12327,356,
rw,39,14,347,46,370,11957,416,
goni,39,14,262,131,109,12218,240,
kenett,39,14,12,381,456,11871,837,
fe,39,14,39,354,0,12327,354,
rw,39,15,356,37,397,11930,434,
goni,39,15,277,116,116,12211,232,
kenett,39,15,17,376,451,11876,827,
fe,39,15,42,351,0,12327,351,
rw,39,16,356,37,424,11903,461,
goni,39,16,280,113,124,12203,237,
kenett,39,16,16,377,452,11875,829,
fe,39,16,45,348,0,12327,348,
rw,39,17,359,34,448,11879,482,
goni,39,17,287,106,128,12199,234,
kenett,39,17,25,368,443,11884,811,
fe,39,17,48,345,0,12327,345,
rw,39,18,364,29,473,11854,502,
goni,39,18,290,103,141,12186,244,
kenett,39,18,21,372,447,11880,819,
fe,39,18,51,342,0,12327,342,
rw,39,19,367,26,490,11837,516,
goni,39,19,301,92,149,12178,241,
kenett,39,19,29,364,442,11885,806,
fe,39,19,54,339,0,12327,339,
rw,39,20,370,23,515,11812,538,
goni,39,20,308,85,166,12161,251,
kenett,39,20,231,162,243,12084,405,
fe,39,20,57,336,0,12327,336,
rw,39,21,371,22,532,11795,554,
goni,39,21,312,81,183,12144,264,
kenett,39,21,227,166,247,12080,413,
fe,39,21,59,334,0,12327,334,
rw,39,22,375,18,557,11770,575,
goni,39,22,324,69,190,12137,259,
kenett,39,22,235,158,239,12088,397,
fe,39,22,62,331,0,12327,331,
rw,39,23,377,16,580,11747,596,
goni,39,23,327,66,203,12124,269,
kenett,39,23,240,153,234,12093,387,
fe,39,23,64,329,0,12327,329,
rw,39,24,381,12,602,11725,614,
goni,39,24,331,62,215,12112,277,
kenett,39,24,241,152,233,12094,385,
fe,39,24,66,327,0,12327,327,
rw,39,25,381,12,625,11702,637,
goni,39,25,335,58,221,12106,279,
kenett,39,25,243,150,231,12096,381,
fe,39,25,69,324,0,12327,324,
rw,39,26,382,11,637,11690,648,
goni,39,26,340,53,226,12101,279,
kenett,39,26,251,142,223,12104,365,
fe,39,26,71,322,0,12327,322,
rw,39,27,383,10,666,11661,676,
goni,39,27,344,49,233,12094,282,
kenett,39,27,243,150,231,12096,381,
fe,39,27,73,320,0,12327,320,
rw,39,28,383,10,686,11641,696,
goni,39,28,344,49,241,12086,290,
kenett,39,28,250,143,224,12103,367,
fe,39,28,75,318,0,12327,318,
rw,39,29,386,7,711,11616,718,
goni,39,29,346,47,243,12084,290,
kenett,39,29,252,141,222,12105,363,
fe,39,29,78,315,0,12327,315,
rw,39,30,388,5,734,11593,739,
goni,39,30,350,43,258,12069,301,
kenett,39,30,249,144,225,12102,369,
fe,39,30,80,313,0,12327,313,
rw,39,31,390,3,759,11568,762,
goni,39,31,352,41,272,12055,313,
kenett,39,31,248,145,226,12101,371,
fe,39,31,81,312,0,12327,312,
rw,39,32,392,1,773,11554,774,
goni,39,32,355,38,275,12052,313,
kenett,39,32,248,145,226,12101,371,
fe,39,32,82,311,0,12327,311,
rw,39,33,392,1,794,11533,795,
goni,39,33,358,35,288,12039,323,
kenett,39,33,257,136,217,12110,353,
fe,39,33,84,309,0,12327,309,
rw,39,34,392,1,808,11519,809,
goni,39,34,361,32,291,12036,323,
kenett,39,34,257,136,217,12110,353,
fe,39,34,86,307,0,12327,307,
rw,39,35,392,1,825,11502,826,
goni,39,35,362,31,295,12032,326,
kenett,39,35,266,127,208,12119,335,
fe,39,35,88,305,0,12327,305,
rw,39,36,392,1,837,11490,838,
goni,39,36,364,29,304,12023,333,
kenett,39,36,267,126,207,12120,333,
fe,39,36,89,304,0,12327,304,
rw,39,37,392,1,854,11473,855,
goni,39,37,366,27,309,12018,336,
kenett,39,37,270,123,204,12123,327,
fe,39,37,90,303,0,12327,303,
rw,39,38,392,1,876,11451,877,
goni,39,38,368,25,316,12011,341,
kenett,39,38,270,123,204,12123,327,
fe,39,38,93,300,0,12327,300,
rw,39,39,392,1,894,11433,895,
goni,39,39,369,24,319,12008,343,
kenett,39,39,265,128,209,12118,337,
fe,39,39,96,297,0,12327,297,
rw,39,40,392,1,917,11410,918,
goni,39,40,371,22,323,12004,345,
kenett,39,40,268,125,206,12121,331,
fe,39,40,98,295,0,12327,295,
rw,39,41,392,1,933,11394,934,
goni,39,41,372,21,324,12003,345,
kenett,39,41,267,126,207,12120,333,
fe,39,41,99,294,0,12327,294,
rw,39,42,392,1,953,11374,954,
goni,39,42,372,21,336,11991,357,
kenett,39,42,263,130,211,12116,341,
fe,39,42,101,292,0,12327,292,
rw,39,43,392,1,967,11360,968,
goni,39,43,372,21,340,11987,361,
kenett,39,43,263,130,211,12116,341,
fe,39,43,103,290,0,12327,290,
rw,39,44,392,1,982,11345,983,
goni,39,44,372,21,345,11982,366,
kenett,39,44,271,122,203,12124,325,
fe,39,44,106,287,0,12327,287,
rw,39,45,392,1,1000,11327,1001,
goni,39,45,371,22,357,11970,379,
kenett,39,45,270,123,204,12123,327,
fe,39,45,108,285,0,12327,285,
rw,39,46,392,1,1019,11308,1020,
goni,39,46,373,20,364,11963,384,
kenett,39,46,275,118,199,12128,317,
fe,39,46,110,283,0,12327,283,
rw,39,47,393,0,1043,11284,1043,
goni,39,47,374,19,376,11951,395,
kenett,39,47,271,122,203,12124,325,
fe,39,47,110,283,0,12327,283,
rw,39,48,393,0,1061,11266,1061,
goni,39,48,374,19,390,11937,409,
kenett,39,48,273,120,201,12126,321,
fe,39,48,112,281,0,12327,281,
rw,39,49,393,0,1074,11253,1074,
goni,39,49,377,16,393,11934,409,
kenett,39,49,273,120,201,12126,321,
fe,39,49,113,280,0,12327,280,
rw,39,50,393,0,1085,11242,1085,
goni,39,50,378,15,396,11931,411,
kenett,39,50,272,121,202,12125,323,
fe,39,50,115,278,0,12327,278,
rw,40,1,66,327,33,12294,360,
goni,40,1,5,388,0,12327,388,
kenett,40,1,16,377,224,12103,601,
fe,40,1,3,390,0,12327,390,
rw,40,2,123,270,67,12260,337,
goni,40,2,25,368,3,12324,371,
kenett,40,2,20,373,337,11990,710,
fe,40,2,5,388,0,12327,388,
rw,40,3,171,222,97,12230,319,
goni,40,3,56,337,12,12315,349,
kenett,40,3,24,369,396,11931,765,
fe,40,3,8,385,0,12327,385,
rw,40,4,205,188,122,12205,310,
goni,40,4,76,317,21,12306,338,
kenett,40,4,19,374,410,11917,784,
fe,40,4,11,382,0,12327,382,
rw,40,5,234,159,151,12176,310,
goni,40,5,113,280,32,12295,312,
kenett,40,5,14,379,436,11891,815,
fe,40,5,14,379,0,12327,379,
rw,40,6,265,128,177,12150,305,
goni,40,6,144,249,44,12283,293,
kenett,40,6,19,374,437,11890,811,
fe,40,6,17,376,0,12327,376,
rw,40,7,291,102,202,12125,304,
goni,40,7,171,222,62,12265,284,
kenett,40,7,16,377,443,11884,820,
fe,40,7,20,373,0,12327,373,
rw,40,8,311,82,230,12097,312,
goni,40,8,195,198,72,12255,270,
kenett,40,8,11,382,457,11870,839,
fe,40,8,23,370,0,12327,370,
rw,40,9,324,69,272,12055,341,
goni,40,9,208,185,85,12242,270,
kenett,40,9,18,375,450,11877,825,
fe,40,9,26,367,0,12327,367,
rw,40,10,336,57,302,12025,359,
goni,40,10,230,163,102,12225,265,
kenett,40,10,29,364,442,11885,806,
fe,40,10,29,364,0,12327,364,
rw,40,11,347,46,339,11988,385,
goni,40,11,241,152,110,12217,262,
kenett,40,11,31,362,440,11887,802,
fe,40,11,32,361,0,12327,361,
rw,40,12,354,39,356,11971,395,
goni,40,12,253,140,118,12209,258,
kenett,40,12,26,367,445,11882,812,
fe,40,12,35,358,0,12327,358,
rw,40,13,359,34,383,11944,417,
goni,40,13,263,130,125,12202,255,
kenett,40,13,192,201,282,12045,483,
fe,40,13,38,355,0,12327,355,
rw,40,14,363,30,411,11916,441,
goni,40,14,278,115,139,12188,254,
kenett,40,14,195,198,279,12048,477,
fe,40,14,41,352,0,12327,352,
rw,40,15,369,24,434,11893,458,
goni,40,15,292,101,154,12173,255,
kenett,40,15,209,184,265,12062,449,
fe,40,15,44,349,0,12327,349,
rw,40,16,372,21,454,11873,475,
goni,40,16,303,90,167,12160,257,
kenett,40,16,216,177,258,12069,435,
fe,40,16,47,346,0,12327,346,
rw,40,17,374,19,486,11841,505,
goni,40,17,309,84,180,12147,264,
kenett,40,17,225,168,249,12078,417,
fe,40,17,50,343,0,12327,343,
rw,40,18,378,15,503,11824,518,
goni,40,18,316,77,186,12141,263,
kenett,40,18,223,170,251,12076,421,
fe,40,18,53,340,0,12327,340,
rw,40,19,380,13,525,11802,538,
goni,40,19,322,71,201,12126,272,
kenett,40,19,221,172,253,12074,425,
fe,40,19,56,337,0,12327,337,
rw,40,20,380,13,551,11776,564,
goni,40,20,329,64,212,12115,276,
kenett,40,20,231,162,243,12084,405,
fe,40,20,59,334,0,12327,334,
rw,40,21,381,12,571,11756,583,
goni,40,21,329,64,222,12105,286,
kenett,40,21,233,160,241,12086,401,
fe,40,21,61,332,0,12327,332,
rw,40,22,382,11,596,11731,607,
goni,40,22,332,61,223,12104,284,
kenett,40,22,235,158,239,12088,397,
fe,40,22,64,329,0,12327,329,
rw,40,23,383,10,623,11704,633,
goni,40,23,337,56,224,12103,280,
kenett,40,23,242,151,232,12095,383,
fe,40,23,66,327,0,12327,327,
rw,40,24,388,5,642,11685,647,
goni,40,24,344,49,235,12092,284,
kenett,40,24,251,142,223,12104,365,
fe,40,24,68,325,0,12327,325,
rw,40,25,388,5,664,11663,669,
goni,40,25,346,47,251,12076,298,
kenett,40,25,245,148,229,12098,377,
fe,40,25,71,322,0,12327,322,
rw,40,26,388,5,688,11639,693,
goni,40,26,348,45,254,12073,299,
kenett,40,26,253,140,221,12106,361,
fe,40,26,74,319,0,12327,319,
rw,40,27,389,4,708,11619,712,
goni,40,27,351,42,265,12062,307,
kenett,40,27,252,141,222,12105,363,
fe,40,27,75,318,0,12327,318,
rw,40,28,389,4,731,11596,735,
goni,40,28,357,36,268,12059,304,
kenett,40,28,259,134,215,12112,349,
fe,40,28,78,315,0,12327,315,
rw,40,29,389,4,749,11578,753,
goni,40,29,356,37,278,12049,315,
kenett,40,29,256,137,218,12109,355,
fe,40,29,81,312,0,12327,312,
rw,40,30,390,3,767,11560,770,
goni,40,30,357,36,290,12037,326,
kenett,40,30,265,128,209,12118,337,
fe,40,30,81,312,0,12327,312,
rw,40,31,390,3,790,11537,793,
goni,40,31,358,35,292,12035,327,
kenett,40,31,267,126,207,12120,333,
fe,40,31,84,309,0,12327,309,
rw,40,32,391,2,812,11515,814,
goni,40,32,360,33,298,12029,331,
kenett,40,32,262,131,212,12115,343,
fe,40,32,87,306,0,12327,306,
rw,40,33,391,2,835,11492,837,
goni,40,33,361,32,307,12020,339,
kenett,40,33,265,128,209,12118,337,
fe,40,33,90,303,0,12327,303,
rw,40,34,391,2,851,11476,853,
goni,40,34,363,30,317,12010,347,
kenett,40,34,271,122,203,12124,325,
fe,40,34,92,301,0,12327,301,
rw,40,35,391,2,877,11450,879,
goni,40,35,365,28,333,11994,361,
kenett,40,35,265,128,209,12118,337,
fe,40,35,94,299,0,12327,299,
rw,40,36,391,2,894,11433,896,
goni,40,36,365,28,345,11982,373,
kenett,40,36,273,120,201,12126,321,
fe,40,36,96,297,0,12327,297,
rw,40,37,391,2,911,11416,913,
goni,40,37,367,26,349,11978,375,
kenett,40,37,275,118,199,12128,317,
fe,40,37,98,295,0,12327,295,
rw,40,38,391,2,927,11400,929,
goni,40,38,367,26,351,11976,377,
kenett,40,38,276,117,198,12129,315,
fe,40,38,101,292,0,12327,292,
rw,40,39,392,1,942,11385,943,
goni,40,39,366,27,358,11969,385,
kenett,40,39,269,124,205,12122,329,
fe,40,39,101,292,0,12327,292,
rw,40,40,392,1,965,11362,966,
goni,40,40,368,25,362,11965,387,
kenett,40,40,281,112,193,12134,305,
fe,40,40,102,291,0,12327,291,
rw,40,41,392,1,979,11348,980,
goni,40,41,371,22,363,11964,385,
kenett,40,41,268,125,206,12121,331,
fe,40,41,104,289,0,12327,289,
rw,40,42,392,1,998,11329,999,
goni,40,42,374,19,382,11945,401,
kenett,40,42,271,122,203,12124,325,
fe,40,42,107,286,0,12327,286,
rw,40,43,392,1,1019,11308,1020,
goni,40,43,375,18,386,11941,404,
kenett,40,43,275,118,199,12128,317,
fe,40,43,110,283,0,12327,283,
rw,40,44,393,0,1039,11288,1039,
goni,40,44,374,19,388,11939,407,
kenett,40,44,284,109,190,12137,299,
fe,40,44,113,280,0,12327,280,
rw,40,45,393,0,1053,11274,1053,
goni,40,45,372,21,393,11934,414,
kenett,40,45,279,114,195,12132,309,
fe,40,45,115,278,0,12327,278,
rw,40,46,393,0,1064,11263,1064,
goni,40,46,375,18,396,11931,414,
kenett,40,46,279,114,195,12132,309,
fe,40,46,117,276,0,12327,276,
rw,40,47,393,0,1077,11250,1077,
goni,40,47,377,16,409,11918,425,
kenett,40,47,281,112,193,12134,305,
fe,40,47,120,273,0,12327,273,
rw,40,48,393,0,1091,11236,1091,
goni,40,48,379,14,412,11915,426,
kenett,40,48,281,112,193,12134,305,
fe,40,48,121,272,0,12327,272,
rw,40,49,393,0,1109,11218,1109,
goni,40,49,380,13,412,11915,425,
kenett,40,49,281,112,193,12134,305,
fe,40,49,122,271,0,12327,271,
rw,40,50,393,0,1121,11206,1121,
goni,40,50,382,11,421,11906,432,
kenett,40,50,278,115,196,12131,311,
fe,40,50,125,268,0,12327,268,
rw,41,1,62,331,36,12291,367,
goni,41,1,6,387,1,12326,388,
kenett,41,1,12,381,195,12132,576,
fe,41,1,3,390,0,12327,390,
rw,41,2,114,279,69,12258,348,
goni,41,2,26,367,7,12320,374,
kenett,41,2,22,371,317,12010,688,
fe,41,2,6,387,0,12327,387,
rw,41,3,167,226,98,12229,324,
goni,41,3,57,336,14,12313,350,
kenett,41,3,20,373,376,11951,749,
fe,41,3,9,384,0,12327,384,
rw,41,4,202,191,125,12202,316,
goni,41,4,81,312,22,12305,334,
kenett,41,4,20,373,406,11921,779,
fe,41,4,12,381,0,12327,381,
rw,41,5,230,163,148,12179,311,
goni,41,5,115,278,35,12292,313,
kenett,41,5,17,376,436,11891,812,
fe,41,5,15,378,0,12327,378,
rw,41,6,250,143,183,12144,326,
goni,41,6,127,266,45,12282,311,
kenett,41,6,17,376,439,11888,815,
fe,41,6,18,375,0,12327,375,
rw,41,7,273,120,219,12108,339,
goni,41,7,153,240,55,12272,295,
kenett,41,7,24,369,441,11886,810,
fe,41,7,20,373,0,12327,373,
rw,41,8,290,103,253,12074,356,
goni,41,8,166,227,64,12263,291,
kenett,41,8,19,374,449,11878,823,
fe,41,8,23,370,0,12327,370,
rw,41,9,305,88,283,12044,371,
goni,41,9,187,206,73,12254,279,
kenett,41,9,19,374,449,11878,823,
fe,41,9,25,368,0,12327,368,
rw,41,10,321,72,303,12024,375,
goni,41,10,196,197,79,12248,276,
kenett,41,10,14,379,454,11873,833,
fe,41,10,27,366,0,12327,366,
rw,41,11,338,55,328,11999,383,
goni,41,11,229,164,92,12235,256,
kenett,41,11,20,373,448,11879,821,
fe,41,11,30,363,0,12327,363,
rw,41,12,345,48,358,11969,406,
goni,41,12,248,145,115,12212,260,
kenett,41,12,25,368,443,11884,811,
fe,41,12,33,360,0,12327,360,
rw,41,13,350,43,377,11950,420,
goni,41,13,265,128,122,12205,250,
kenett,41,13,22,371,446,11881,817,
fe,41,13,36,357,0,12327,357,
rw,41,14,357,36,410,11917,446,
goni,41,14,283,110,136,12191,246,
kenett,41,14,25,368,443,11884,811,
fe,41,14,38,355,0,12327,355,
rw,41,15,363,30,440,11887,470,
goni,41,15,289,104,135,12192,239,
kenett,41,15,24,369,444,11883,813,
fe,41,15,41,352,0,12327,352,
rw,41,16,368,25,465,11862,490,
goni,41,16,296,97,152,12175,249,
kenett,41,16,30,363,441,11886,804,
fe,41,16,44,349,0,12327,349,
rw,41,17,371,22,484,11843,506,
goni,41,17,301,92,161,12166,253,
kenett,41,17,214,179,260,12067,439,
fe,41,17,45,348,0,12327,348,
rw,41,18,375,18,509,11818,527,
goni,41,18,311,82,166,12161,248,
kenett,41,18,213,180,261,12066,441,
fe,41,18,48,345,0,12327,345,
rw,41,19,378,15,530,11797,545,
goni,41,19,319,74,176,12151,250,
kenett,41,19,220,173,254,12073,427,
fe,41,19,51,342,0,12327,342,
rw,41,20,379,14,549,11778,563,
goni,41,20,321,72,188,12139,260,
kenett,41,20,220,173,254,12073,427,
fe,41,20,53,340,0,12327,340,
rw,41,21,380,13,567,11760,580,
goni,41,21,321,72,198,12129,270,
kenett,41,21,219,174,255,12072,429,
fe,41,21,55,338,0,12327,338,
rw,41,22,383,10,589,11738,599,
goni,41,22,329,64,201,12126,265,
kenett,41,22,243,150,231,12096,381,
fe,41,22,58,335,0,12327,335,
rw,41,23,383,10,609,11718,619,
goni,41,23,333,60,215,12112,275,
kenett,41,23,245,148,229,12098,377,
fe,41,23,61,332,0,12327,332,
rw,41,24,387,6,627,11700,633,
goni,41,24,337,56,218,12109,274,
kenett,41,24,250,143,224,12103,367,
fe,41,24,63,330,0,12327,330,
rw,41,25,387,6,646,11681,652,
goni,41,25,342,51,226,12101,277,
kenett,41,25,252,141,222,12105,363,
fe,41,25,66,327,0,12327,327,
rw,41,26,388,5,663,11664,668,
goni,41,26,348,45,236,12091,281,
kenett,41,26,253,140,221,12106,361,
fe,41,26,69,324,0,12327,324,
rw,41,27,388,5,690,11637,695,
goni,41,27,354,39,253,12074,292,
kenett,41,27,246,147,228,12099,375,
fe,41,27,72,321,0,12327,321,
rw,41,28,388,5,709,11618,714,
goni,41,28,356,37,260,12067,297,
kenett,41,28,250,143,224,12103,367,
fe,41,28,75,318,0,12327,318,
rw,41,29,388,5,735,11592,740,
goni,41,29,356,37,270,12057,307,
kenett,41,29,253,140,221,12106,361,
fe,41,29,76,317,0,12327,317,
rw,41,30,389,4,755,11572,759,
goni,41,30,361,32,275,12052,307,
kenett,41,30,259,134,215,12112,349,
fe,41,30,79,314,0,12327,314,
rw,41,31,390,3,775,11552,778,
goni,41,31,363,30,287,12040,317,
kenett,41,31,257,136,217,12110,353,
fe,41,31,82,311,0,12327,311,
rw,41,32,390,3,793,11534,796,
goni,41,32,365,28,286,12041,314,
kenett,41,32,258,135,216,12111,351,
fe,41,32,82,311,0,12327,311,
rw,41,33,390,3,816,11511,819,
goni,41,33,365,28,302,12025,330,
kenett,41,33,256,137,218,12109,355,
fe,41,33,85,308,0,12327,308,
rw,41,34,390,3,832,11495,835,
goni,41,34,369,24,311,12016,335,
kenett,41,34,257,136,217,12110,353,
fe,41,34,88,305,0,12327,305,
rw,41,35,390,3,850,11477,853,
goni,41,35,368,25,318,12009,343,
kenett,41,35,262,131,212,12115,343,
fe,41,35,91,302,0,12327,302,
rw,41,36,391,2,872,11455,874,
goni,41,36,369,24,331,11996,355,
kenett,41,36,261,132,213,12114,345,
fe,41,36,94,299,0,12327,299,
rw,41,37,391,2,887,11440,889,
goni,41,37,371,22,343,11984,365,
kenett,41,37,268,125,206,12121,331,
fe,41,37,96,297,0,12327,297,
rw,41,38,391,2,905,11422,907,
goni,41,38,368,25,352,11975,377,
kenett,41,38,262,131,212,12115,343,
fe,41,38,98,295,0,12327,295,
rw,41,39,391,2,926,11401,928,
goni,41,39,367,26,360,11967,386,
kenett,41,39,266,127,208,12119,335,
fe,41,39,100,293,0,12327,293,
rw,41,40,391,2,942,11385,944,
goni,41,40,370,23,369,11958,392,
kenett,41,40,267,126,207,12120,333,
fe,41,40,101,292,0,12327,292,
rw,41,41,392,1,956,11371,957,
goni,41,41,370,23,369,11958,392,
kenett,41,41,262,131,212,12115,343,
fe,41,41,101,292,0,12327,292,
rw,41,42,392,1,969,11358,970,
goni,41,42,370,23,376,11951,399,
kenett,41,42,271,122,203,12124,325,
fe,41,42,102,291,0,12327,291,
rw,41,43,392,1,987,11340,988,
goni,41,43,372,21,384,11943,405,
kenett,41,43,270,123,204,12123,327,
fe,41,43,105,288,0,12327,288,
rw,41,44,392,1,1013,11314,1014,
goni,41,44,373,20,378,11949,398,
kenett,41,44,272,121,202,12125,323,
fe,41,44,108,285,0,12327,285,
rw,41,45,392,1,1030,11297,1031,
goni,41,45,374,19,393,11934,412,
kenett,41,45,270,123,204,12123,327,
fe,41,45,110,283,0,12327,283,
rw,41,46,392,1,1044,11283,1045,
goni,41,46,375,18,400,11927,418,
kenett,41,46,271,122,203,12124,325,
fe,41,46,112,281,0,12327,281,
rw,41,47,392,1,1060,11267,1061,
goni,41,47,376,17,403,11924,420,
kenett,41,47,270,123,204,12123,327,
fe,41,47,114,279,0,12327,279,
rw,41,48,392,1,1068,11259,1069,
goni,41,48,377,16,409,11918,425,
kenett,41,48,275,118,199,12128,317,
fe,41,48,116,277,0,12327,277,
rw,41,49,392,1,1082,11245,1083,
goni,41,49,379,14,409,11918,423,
kenett,41,49,271,122,203,12124,325,
fe,41,49,117,276,0,12327,276,
rw,41,50,392,1,1098,11229,1099,
goni,41,50,379,14,413,11914,427,
kenett,41,50,272,121,202,12125,323,
fe,41,50,119,274,0,12327,274,
rw,42,1,74,319,27,12300,346,
goni,42,1,5,388,2,12325,390,
kenett,42,1,10,383,209,12118,592,
fe,42,1,3,390,0,12327,390,
rw,42,2,129,264,58,12269,322,
goni,42,2,27,366,4,12323,370,
kenett,42,2,15,378,342,11985,720,
fe,42,2,6,387,0,12327,387,
rw,42,3,175,218,84,12243,302,
goni,42,3,62,331,21,12306,352,
kenett,42,3,17,376,394,11933,770,
fe,42,3,9,384,0,12327,384,
rw,42,4,218,175,106,12221,281,
goni,42,4,88,305,28,12299,333,
kenett,42,4,15,378,408,11919,786,
fe,42,4,12,381,0,12327,381,
rw,42,5,247,146,142,12185,288,
goni,42,5,134,259,41,12286,300,
kenett,42,5,17,376,433,11894,809,
fe,42,5,15,378,0,12327,378,
rw,42,6,272,121,166,12161,287,
goni,42,6,165,228,57,12270,285,
kenett,42,6,14,379,448,11879,827,
fe,42,6,17,376,0,12327,376,
rw,42,7,291,102,191,12136,293,
goni,42,7,186,207,71,12256,278,
kenett,42,7,15,378,447,11880,825,
fe,42,7,20,373,0,12327,373,
rw,42,8,305,88,231,12096,319,
goni,42,8,187,206,77,12250,283,
kenett,42,8,20,373,445,11882,818,
fe,42,8,23,370,0,12327,370,
rw,42,9,314,79,262,12065,341,
goni,42,9,209,184,87,12240,271,
kenett,42,9,22,371,443,11884,814,
fe,42,9,25,368,0,12327,368,
rw,42,10,328,65,289,12038,354,
goni,42,10,238,155,103,12224,258,
kenett,42,10,14,379,454,11873,833,
fe,42,10,28,365,0,12327,365,
rw,42,11,335,58,317,12010,375,
goni,42,11,251,142,101,12226,243,
kenett,42,11,18,375,450,11877,825,
fe,42,11,31,362,0,12327,362,
rw,42,12,346,47,336,11991,383,
goni,42,12,268,125,118,12209,243,
kenett,42,12,19,374,449,11878,823,
fe,42,12,34,359,0,12327,359,
rw,42,13,352,41,360,11967,401,
goni,42,13,279,114,130,12197,244,
kenett,42,13,13,380,455,11872,835,
fe,42,13,36,357,0,12327,357,
rw,42,14,357,36,387,11940,423,
goni,42,14,289,104,147,12180,251,
kenett,42,14,14,379,454,11873,833,
fe,42,14,39,354,0,12327,354,
rw,42,15,365,28,418,11909,446,
goni,42,15,300,93,146,12181,239,
kenett,42,15,32,361,439,11888,800,
fe,42,15,42,351,0,12327,351,
rw,42,16,370,23,441,11886,464,
goni,42,16,305,88,161,12166,249,
kenett,42,16,38,355,433,11894,788,
fe,42,16,44,349,0,12327,349,
rw,42,17,374,19,462,11865,481,
goni,42,17,309,84,171,12156,255,
kenett,42,17,27,366,444,11883,810,
fe,42,17,46,347,0,12327,347,
rw,42,18,378,15,492,11835,507,
goni,42,18,308,85,178,12149,263,
kenett,42,18,217,176,257,12070,433,
fe,42,18,48,345,0,12327,345,
rw,42,19,379,14,512,11815,526,
goni,42,19,316,77,187,12140,264,
kenett,42,19,223,170,251,12076,421,
fe,42,19,51,342,0,12327,342,
rw,42,20,380,13,532,11795,545,
goni,42,20,318,75,192,12135,267,
kenett,42,20,223,170,251,12076,421,
fe,42,20,53,340,0,12327,340,
rw,42,21,382,11,550,11777,561,
goni,42,21,331,62,208,12119,270,
kenett,42,21,221,172,253,12074,425,
fe,42,21,55,338,0,12327,338,
rw,42,22,382,11,575,11752,586,
goni,42,22,333,60,219,12108,279,
kenett,42,22,223,170,251,12076,421,
fe,42,22,58,335,0,12327,335,
rw,42,23,384,9,593,11734,602,
goni,42,23,333,60,231,12096,291,
kenett,42,23,237,156,237,12090,393,
fe,42,23,61,332,0,12327,332,
rw,42,24,384,9,618,11709,627,
goni,42,24,338,55,237,12090,292,
kenett,42,24,233,160,241,12086,401,
fe,42,24,64,329,0,12327,329,
rw,42,25,385,8,635,11692,643,
goni,42,25,344,49,242,12085,291,
kenett,42,25,236,157,238,12089,395,
fe,42,25,67,326,0,12327,326,
rw,42,26,387,6,658,11669,664,
goni,42,26,351,42,250,12077,292,
kenett,42,26,237,156,237,12090,393,
fe,42,26,69,324,0,12327,324,
rw,42,27,389,4,673,11654,677,
goni,42,27,353,40,265,12062,305,
kenett,42,27,247,146,227,12100,373,
fe,42,27,71,322,0,12327,322,
rw,42,28,390,3,693,11634,696,
goni,42,28,353,40,266,12061,306,
kenett,42,28,248,145,226,12101,371,
fe,42,28,73,320,0,12327,320,
rw,42,29,390,3,717,11610,720,
goni,42,29,356,37,266,12061,303,
kenett,42,29,247,146,227,12100,373,
fe,42,29,76,317,0,12327,317,
rw,42,30,390,3,736,11591,739,
goni,42,30,355,38,273,12054,311,
kenett,42,30,256,137,218,12109,355,
fe,42,30,79,314,0,12327,314,
rw,42,31,390,3,756,11571,759,
goni,42,31,361,32,290,12037,322,
kenett,42,31,258,135,216,12111,351,
fe,42,31,80,313,0,12327,313,
rw,42,32,390,3,783,11544,786,
goni,42,32,363,30,298,12029,328,
kenett,42,32,258,135,216,12111,351,
fe,42,32,83,310,0,12327,310,
rw,42,33,391,2,802,11525,804,
goni,42,33,364,29,310,12017,339,
kenett,42,33,256,137,218,12109,355,
fe,42,33,85,308,0,12327,308,
rw,42,34,391,2,816,11511,818,
goni,42,34,367,26,316,12011,342,
kenett,42,34,260,133,214,12113,347,
fe,42,34,88,305,0,12327,305,
rw,42,35,392,1,835,11492,836,
goni,42,35,366,27,325,12002,352,
kenett,42,35,264,129,210,12117,339,
fe,42,35,89,304,0,12327,304,
rw,42,36,392,1,857,11470,858,
goni,42,36,371,22,328,11999,350,
kenett,42,36,254,139,220,12107,359,
fe,42,36,92,301,0,12327,301,
rw,42,37,392,1,872,11455,873,
goni,42,37,371,22,333,11994,355,
kenett,42,37,258,135,216,12111,351,
fe,42,37,95,298,0,12327,298,
rw,42,38,392,1,889,11438,890,
goni,42,38,373,20,335,11992,355,
kenett,42,38,266,127,208,12119,335,
fe,42,38,97,296,0,12327,296,
rw,42,39,392,1,905,11422,906,
goni,42,39,374,19,340,11987,359,
kenett,42,39,263,130,211,12116,341,
fe,42,39,99,294,0,12327,294,
rw,42,40,392,1,919,11408,920,
goni,42,40,374,19,356,11971,375,
kenett,42,40,268,125,206,12121,331,
fe,42,40,99,294,0,12327,294,
rw,42,41,392,1,932,11395,933,
goni,42,41,374,19,358,11969,377,
kenett,42,41,263,130,211,12116,341,
fe,42,41,102,291,0,12327,291,
rw,42,42,392,1,944,11383,945,
goni,42,42,375,18,365,11962,383,
kenett,42,42,263,130,211,12116,341,
fe,42,42,104,289,0,12327,289,
rw,42,43,392,1,959,11368,960,
goni,42,43,378,15,370,11957,385,
kenett,42,43,267,126,207,12120,333,
fe,42,43,105,288,0,12327,288,
rw,42,44,392,1,979,11348,980,
goni,42,44,378,15,379,11948,394,
kenett,42,44,264,129,210,12117,339,
fe,42,44,107,286,0,12327,286,
rw,42,45,392,1,990,11337,991,
goni,42,45,380,13,396,11931,409,
kenett,42,45,270,123,204,12123,327,
fe,42,45,109,284,0,12327,284,
rw,42,46,393,0,1005,11322,1005,
goni,42,46,381,12,400,11927,412,
kenett,42,46,272,121,202,12125,323,
fe,42,46,111,282,0,12327,282,
rw,42,47,393,0,1017,11310,1017,
goni,42,47,380,13,406,11921,419,
kenett,42,47,274,119,200,12127,319,
fe,42,47,113,280,0,12327,280,
rw,42,48,393,0,1035,11292,1035,
goni,42,48,381,12,416,11911,428,
kenett,42,48,278,115,196,12131,311,
fe,42,48,115,278,0,12327,278,
rw,42,49,393,0,1050,11277,1050,
goni,42,49,382,11,421,11906,432,
kenett,42,49,280,113,194,12133,307,
fe,42,49,116,277,0,12327,277,
rw,42,50,393,0,1066,11261,1066,
goni,42,50,382,11,430,11897,441,
kenett,42,50,275,118,199,12128,317,
fe,42,50,118,275,0,12327,275,
rw,43,1,63,330,32,12295,362,
goni,43,1,8,385,1,12326,386,
kenett,43,1,19,374,158,12169,532,
fe,43,1,3,390,0,12327,390,
rw,43,2,111,282,64,12263,346,
goni,43,2,34,359,12,12315,371,
kenett,43,2,14,379,301,12026,680,
fe,43,2,6,387,0,12327,387,
rw,43,3,167,226,89,12238,315,
goni,43,3,61,332,20,12307,352,
kenett,43,3,18,375,375,11952,750,
fe,43,3,9,384,0,12327,384,
rw,43,4,204,189,115,12212,304,
goni,43,4,96,297,29,12298,326,
kenett,43,4,13,380,413,11914,793,
fe,43,4,12,381,0,12327,381,
rw,43,5,233,160,143,12184,303,
goni,43,5,122,271,39,12288,310,
kenett,43,5,14,379,433,11894,812,
fe,43,5,15,378,0,12327,378,
rw,43,6,255,138,170,12157,308,
goni,43,6,140,253,46,12281,299,
kenett,43,6,19,374,431,11896,805,
fe,43,6,17,376,0,12327,376,
rw,43,7,275,118,201,12126,319,
goni,43,7,162,231,54,12273,285,
kenett,43,7,19,374,446,11881,820,
fe,43,7,20,373,0,12327,373,
rw,43,8,294,99,231,12096,330,
goni,43,8,181,212,65,12262,277,
kenett,43,8,25,368,440,11887,808,
fe,43,8,23,370,0,12327,370,
rw,43,9,307,86,257,12070,343,
goni,43,9,208,185,84,12243,269,
kenett,43,9,17,376,448,11879,824,
fe,43,9,26,367,0,12327,367,
rw,43,10,317,76,284,12043,360,
goni,43,10,218,175,93,12234,268,
kenett,43,10,21,372,447,11880,819,
fe,43,10,29,364,0,12327,364,
rw,43,11,329,64,313,12014,377,
goni,43,11,228,165,89,12238,254,
kenett,43,11,22,371,446,11881,817,
fe,43,11,32,361,0,12327,361,
rw,43,12,337,56,345,11982,401,
goni,43,12,242,151,100,12227,251,
kenett,43,12,19,374,452,11875,826,
fe,43,12,35,358,0,12327,358,
rw,43,13,345,48,366,11961,414,
goni,43,13,260,133,114,12213,247,
kenett,43,13,23,370,448,11879,818,
fe,43,13,37,356,0,12327,356,
rw,43,14,349,44,398,11929,442,
goni,43,14,273,120,126,12201,246,
kenett,43,14,21,372,450,11877,822,
fe,43,14,38,355,0,12327,355,
rw,43,15,352,41,422,11905,463,
goni,43,15,275,118,131,12196,249,
kenett,43,15,20,373,451,11876,824,
fe,43,15,41,352,0,12327,352,
rw,43,16,361,32,444,11883,476,
goni,43,16,293,100,138,12189,238,
kenett,43,16,24,369,447,11880,816,
fe,43,16,44,349,0,12327,349,
rw,43,17,367,26,463,11864,489,
goni,43,17,304,89,143,12184,232,
kenett,43,17,26,367,445,11882,812,
fe,43,17,47,346,0,12327,346,
rw,43,18,372,21,492,11835,513,
goni,43,18,311,82,153,12174,235,
kenett,43,18,228,165,246,12081,411,
fe,43,18,50,343,0,12327,343,
rw,43,19,375,18,511,11816,529,
goni,43,19,319,74,172,12155,246,
kenett,43,19,231,162,243,12084,405,
fe,43,19,52,341,0,12327,341,
rw,43,20,379,14,543,11784,557,
goni,43,20,319,74,184,12143,258,
kenett,43,20,233,160,241,12086,401,
fe,43,20,55,338,0,12327,338,
rw,43,21,381,12,563,11764,575,
goni,43,21,330,63,193,12134,256,
kenett,43,21,241,152,233,12094,385,
fe,43,21,58,335,0,12327,335,
rw,43,22,381,12,585,11742,597,
goni,43,22,331,62,201,12126,263,
kenett,43,22,235,158,239,12088,397,
fe,43,22,60,333,0,12327,333,
rw,43,23,381,12,618,11709,630,
goni,43,23,333,60,210,12117,270,
kenett,43,23,245,148,229,12098,377,
fe,43,23,62,331,0,12327,331,
rw,43,24,384,9,648,11679,657,
goni,43,24,338,55,221,12106,276,
kenett,43,24,235,158,239,12088,397,
fe,43,24,65,328,0,12327,328,
rw,43,25,385,8,663,11664,671,
goni,43,25,344,49,240,12087,289,
kenett,43,25,251,142,223,12104,365,
fe,43,25,68,325,0,12327,325,
rw,43,26,386,7,691,11636,698,
goni,43,26,347,46,250,12077,296,
kenett,43,26,243,150,231,12096,381,
fe,43,26,71,322,0,12327,322,
rw,43,27,386,7,709,11618,716,
goni,43,27,349,44,255,12072,299,
kenett,43,27,253,140,221,12106,361,
fe,43,27,72,321,0,12327,321,
rw,43,28,387,6,731,11596,737,
goni,43,28,351,42,257,12070,299,
kenett,43,28,248,145,226,12101,371,
fe,43,28,75,318,0,12327,318,
rw,43,29,388,5,754,11573,759,
goni,43,29,355,38,265,12062,303,
kenett,43,29,254,139,220,12107,359,
fe,43,29,78,315,0,12327,315,
rw,43,30,388,5,778,11549,783,
goni,43,30,359,34,265,12062,299,
kenett,43,30,260,133,214,12113,347,
fe,43,30,80,313,0,12327,313,
rw,43,31,389,4,791,11536,795,
goni,43,31,359,34,277,12050,311,
kenett,43,31,256,137,218,12109,355,
fe,43,31,83,310,0,12327,310,
rw,43,32,389,4,811,11516,815,
goni,43,32,359,34,282,12045,316,
kenett,43,32,258,135,216,12111,351,
fe,43,32,85,308,0,12327,308,
rw,43,33,389,4,831,11496,835,
goni,43,33,359,34,290,12037,324,
kenett,43,33,261,132,213,12114,345,
fe,43,33,87,306,0,12327,306,
rw,43,34,389,4,856,11471,860,
goni,43,34,361,32,305,12022,337,
kenett,43,34,260,133,214,12113,347,
fe,43,34,90,303,0,12327,303,
rw,43,35,389,4,880,11447,884,
goni,43,35,363,30,314,12013,344,
kenett,43,35,271,122,203,12124,325,
fe,43,35,93,300,0,12327,300,
rw,43,36,391,2,900,11427,902,
goni,43,36,362,31,322,12005,353,
kenett,43,36,268,125,206,12121,331,
fe,43,36,95,298,0,12327,298,
rw,43,37,392,1,916,11411,917,
goni,43,37,365,28,323,12004,351,
kenett,43,37,270,123,204,12123,327,
fe,43,37,96,297,0,12327,297,
rw,43,38,392,1,932,11395,933,
goni,43,38,367,26,331,11996,357,
kenett,43,38,272,121,202,12125,323,
fe,43,38,98,295,0,12327,295,
rw,43,39,392,1,952,11375,953,
goni,43,39,370,23,336,11991,359,
kenett,43,39,266,127,208,12119,335,
fe,43,39,100,293,0,12327,293,
rw,43,40,392,1,968,11359,969,
goni,43,40,372,21,343,11984,364,
kenett,43,40,272,121,202,12125,323,
fe,43,40,102,291,0,12327,291,
rw,43,41,392,1,990,11337,991,
goni,43,41,376,17,357,11970,374,
kenett,43,41,275,118,199,12128,317,
fe,43,41,104,289,0,12327,289,
rw,43,42,392,1,1010,11317,1011,
goni,43,42,375,18,357,11970,375,
kenett,43,42,276,117,198,12129,315,
fe,43,42,106,287,0,12327,287,
rw,43,43,392,1,1031,11296,1032,
goni,43,43,376,17,359,11968,376,
kenett,43,43,274,119,200,12127,319,
fe,43,43,109,284,0,12327,284,
rw,43,44,392,1,1050,11277,1051,
goni,43,44,376,17,368,11959,385,
kenett,43,44,271,122,203,12124,325,
fe,43,44,111,282,0,12327,282,
rw,43,45,393,0,1069,11258,1069,
goni,43,45,378,15,382,11945,397,
kenett,43,45,277,116,197,12130,313,
fe,43,45,112,281,0,12327,281,
rw,43,46,393,0,1085,11242,1085,
goni,43,46,378,15,389,11938,404,
kenett,43,46,273,120,201,12126,321,
fe,43,46,113,280,0,12327,280,
rw,43,47,393,0,1104,11223,1104,
goni,43,47,380,13,395,11932,408,
kenett,43,47,281,112,193,12134,305,
fe,43,47,116,277,0,12327,277,
rw,43,48,393,0,1114,11213,1114,
goni,43,48,381,12,399,11928,411,
kenett,43,48,279,114,195,12132,309,
fe,43,48,117,276,0,12327,276,
rw,43,49,393,0,1134,11193,1134,
goni,43,49,380,13,407,11920,420,
kenett,43,49,278,115,196,12131,311,
fe,43,49,118,275,0,12327,275,
rw,43,50,393,0,1153,11174,1153,
goni,43,50,381,12,410,11917,422,
kenett,43,50,274,119,200,12127,319,
fe,43,50,120,273,0,12327,273,
rw,44,1,69,324,25,12302,349,
goni,44,1,11,382,1,12326,383,
kenett,44,1,17,376,202,12125,578,
fe,44,1,3,390,0,12327,390,
rw,44,2,123,270,55,12272,325,
goni,44,2,33,360,6,12321,366,
kenett,44,2,15,378,318,12009,696,
fe,44,2,5,388,0,12327,388,
rw,44,3,170,223,81,12246,304,
goni,44,3,68,325,10,12317,335,
kenett,44,3,14,379,367,11960,746,
fe,44,3,8,385,0,12327,385,
rw,44,4,211,182,108,12219,290,
goni,44,4,94,299,20,12307,319,
kenett,44,4,20,373,394,11933,767,
fe,44,4,11,382,0,12327,382,
rw,44,5,237,156,139,12188,295,
goni,44,5,120,273,31,12296,304,
kenett,44,5,18,375,423,11904,798,
fe,44,5,14,379,0,12327,379,
rw,44,6,268,125,166,12161,291,
goni,44,6,148,245,39,12288,284,
kenett,44,6,18,375,429,11898,804,
fe,44,6,16,377,0,12327,377,
rw,44,7,285,108,201,12126,309,
goni,44,7,169,224,53,12274,277,
kenett,44,7,24,369,432,11895,801,
fe,44,7,19,374,0,12327,374,
rw,44,8,304,89,232,12095,321,
goni,44,8,192,201,78,12249,279,
kenett,44,8,18,375,450,11877,825,
fe,44,8,22,371,0,12327,371,
rw,44,9,320,73,265,12062,338,
goni,44,9,205,188,96,12231,284,
kenett,44,9,23,370,445,11882,815,
fe,44,9,25,368,0,12327,368,
rw,44,10,338,55,292,12035,347,
goni,44,10,232,161,102,12225,263,
kenett,44,10,181,212,293,12034,505,
fe,44,10,28,365,0,12327,365,
rw,44,11,349,44,320,12007,364,
goni,44,11,236,157,113,12214,270,
kenett,44,11,186,207,288,12039,495,
fe,44,11,31,362,0,12327,362,
rw,44,12,355,38,348,11979,386,
goni,44,12,252,141,131,12196,272,
kenett,44,12,190,203,284,12043,487,
fe,44,12,34,359,0,12327,359,
rw,44,13,364,29,377,11950,406,
goni,44,13,263,130,144,12183,274,
kenett,44,13,198,195,276,12051,471,
fe,44,13,37,356,0,12327,356,
rw,44,14,369,24,409,11918,433,
goni,44,14,279,114,152,12175,266,
kenett,44,14,197,196,277,12050,473,
fe,44,14,40,353,0,12327,353,
rw,44,15,373,20,435,11892,455,
goni,44,15,292,101,153,12174,254,
kenett,44,15,197,196,277,12050,473,
fe,44,15,43,350,0,12327,350,
rw,44,16,374,19,461,11866,480,
goni,44,16,299,94,159,12168,253,
kenett,44,16,192,201,282,12045,483,
fe,44,16,46,347,0,12327,347,
rw,44,17,377,16,490,11837,506,
goni,44,17,310,83,176,12151,259,
kenett,44,17,194,199,280,12047,479,
fe,44,17,49,344,0,12327,344,
rw,44,18,380,13,509,11818,522,
goni,44,18,320,73,183,12144,256,
kenett,44,18,200,193,274,12053,467,
fe,44,18,51,342,0,12327,342,
rw,44,19,382,11,533,11794,544,
goni,44,19,322,71,201,12126,272,
kenett,44,19,206,187,268,12059,455,
fe,44,19,54,339,0,12327,339,
rw,44,20,383,10,563,11764,573,
goni,44,20,326,67,221,12106,288,
kenett,44,20,224,169,250,12077,419,
fe,44,20,57,336,0,12327,336,
rw,44,21,385,8,584,11743,592,
goni,44,21,335,58,224,12103,282,
kenett,44,21,234,159,240,12087,399,
fe,44,21,60,333,0,12327,333,
rw,44,22,385,8,603,11724,611,
goni,44,22,338,55,227,12100,282,
kenett,44,22,221,172,253,12074,425,
fe,44,22,62,331,0,12327,331,
rw,44,23,388,5,625,11702,630,
goni,44,23,341,52,239,12088,291,
kenett,44,23,235,158,239,12088,397,
fe,44,23,64,329,0,12327,329,
rw,44,24,388,5,644,11683,649,
goni,44,24,347,46,239,12088,285,
kenett,44,24,246,147,228,12099,375,
fe,44,24,67,326,0,12327,326,
rw,44,25,388,5,673,11654,678,
goni,44,25,350,43,251,12076,294,
kenett,44,25,239,154,235,12092,389,
fe,44,25,68,325,0,12327,325,
rw,44,26,390,3,695,11632,698,
goni,44,26,355,38,257,12070,295,
kenett,44,26,240,153,234,12093,387,
fe,44,26,70,323,0,12327,323,
rw,44,27,390,3,716,11611,719,
goni,44,27,358,35,264,12063,299,
kenett,44,27,244,149,230,12097,379,
fe,44,27,72,321,0,12327,321,
rw,44,28,390,3,735,11592,738,
goni,44,28,361,32,272,12055,304,
kenett,44,28,243,150,231,12096,381,
fe,44,28,73,320,0,12327,320,
rw,44,29,390,3,747,11580,750,
goni,44,29,365,28,268,12059,296,
kenett,44,29,240,153,234,12093,387,
fe,44,29,76,317,0,12327,317,
rw,44,30,392,1,768,11559,769,
goni,44,30,363,30,281,12046,311,
kenett,44,30,250,143,224,12103,367,
fe,44,30,78,315,0,12327,315,
rw,44,31,392,1,794,11533,795,
goni,44,31,367,26,288,12039,314,
kenett,44,31,256,137,218,12109,355,
fe,44,31,81,312,0,12327,312,
rw,44,32,393,0,809,11518,809,
goni,44,32,367,26,286,12041,312,
kenett,44,32,261,132,213,12114,345,
fe,44,32,84,309,0,12327,309,
rw,44,33,393,0,837,11490,837,
goni,44,33,371,22,293,12034,315,
kenett,44,33,263,130,211,12116,341,
fe,44,33,86,307,0,12327,307,
rw,44,34,393,0,853,11474,853,
goni,44,34,374,19,305,12022,324,
kenett,44,34,252,141,222,12105,363,
fe,44,34,89,304,0,12327,304,
rw,44,35,393,0,877,11450,877,
goni,44,35,374,19,314,12013,333,
kenett,44,35,254,139,220,12107,359,
fe,44,35,91,302,0,12327,302,
rw,44,36,393,0,895,11432,895,
goni,44,36,375,18,310,12017,328,
kenett,44,36,262,131,212,12115,343,
fe,44,36,93,300,0,12327,300,
rw,44,37,393,0,913,11414,913,
goni,44,37,375,18,323,12004,341,
kenett,44,37,255,138,219,12108,357,
fe,44,37,95,298,0,12327,298,
rw,44,38,393,0,933,11394,933,
goni,44,38,376,17,323,12004,340,
kenett,44,38,261,132,213,12114,345,
fe,44,38,97,296,0,12327,296,
rw,44,39,393,0,952,11375,952,
goni,44,39,380,13,333,11994,346,
kenett,44,39,266,127,208,12119,335,
fe,44,39,100,293,0,12327,293,
rw,44,40,393,0,974,11353,974,
goni,44,40,379,14,339,11988,353,
kenett,44,40,268,125,206,12121,331,
fe,44,40,103,290,0,12327,290,
rw,44,41,393,0,993,11334,993,
goni,44,41,380,13,343,11984,356,
kenett,44,41,265,128,209,12118,337,
fe,44,41,105,288,0,12327,288,
rw,44,42,393,0,1016,11311,1016,
goni,44,42,380,13,347,11980,360,
kenett,44,42,263,130,211,12116,341,
fe,44,42,108,285,0,12327,285,
rw,44,43,393,0,1035,11292,1035,
goni,44,43,382,11,356,11971,367,
kenett,44,43,262,131,212,12115,343,
fe,44,43,108,285,0,12327,285,
rw,44,44,393,0,1050,11277,1050,
goni,44,44,381,12,367,11960,379,
kenett,44,44,263,130,211,12116,341,
fe,44,44,109,284,0,12327,284,
rw,44,45,393,0,1071,11256,1071,
goni,44,45,381,12,375,11952,387,
kenett,44,45,263,130,211,12116,341,
fe,44,45,112,281,0,12327,281,
rw,44,46,393,0,1089,11238,1089,
goni,44,46,382,11,380,11947,391,
kenett,44,46,258,135,216,12111,351,
fe,44,46,114,279,0,12327,279,
rw,44,47,393,0,1105,11222,1105,
goni,44,47,380,13,384,11943,397,
kenett,44,47,265,128,209,12118,337,
fe,44,47,115,278,0,12327,278,
rw,44,48,393,0,1122,11205,1122,
goni,44,48,382,11,392,11935,403,
kenett,44,48,268,125,206,12121,331,
fe,44,48,117,276,0,12327,276,
rw,44,49,393,0,1144,11183,1144,
goni,44,49,382,11,401,11926,412,
kenett,44,49,265,128,209,12118,337,
fe,44,49,118,275,0,12327,275,
rw,44,50,393,0,1160,11167,1160,
goni,44,50,383,10,403,11924,413,
kenett,44,50,269,124,205,12122,329,
fe,44,50,120,273,0,12327,273,
rw,45,1,69,324,28,12299,352,
goni,45,1,8,385,1,12326,386,
kenett,45,1,18,375,210,12117,585,
fe,45,1,3,390,0,12327,390,
rw,45,2,124,269,55,12272,324,
goni,45,2,33,360,7,12320,367,
kenett,45,2,16,377,314,12013,691,
fe,45,2,6,387,0,12327,387,
rw,45,3,174,219,86,12241,305,
goni,45,3,57,336,11,12316,347,
kenett,45,3,20,373,394,11933,767,
fe,45,3,9,384,0,12327,384,
rw,45,4,210,183,122,12205,305,
goni,45,4,85,308,19,12308,327,
kenett,45,4,20,373,409,11918,782,
fe,45,4,12,381,0,12327,381,
rw,45,5,237,156,153,12174,309,
goni,45,5,129,264,31,12296,295,
kenett,45,5,18,375,417,11910,792,
fe,45,5,15,378,0,12327,378,
rw,45,6,266,127,177,12150,304,
goni,45,6,146,247,40,12287,287,
kenett,45,6,18,375,432,11895,807,
fe,45,6,18,375,0,12327,375,
rw,45,7,286,107,204,12123,311,
goni,45,7,173,220,45,12282,265,
kenett,45,7,23,370,442,11885,812,
fe,45,7,21,372,0,12327,372,
rw,45,8,300,93,237,12090,330,
goni,45,8,200,193,64,12263,257,
kenett,45,8,25,368,446,11881,814,
fe,45,8,24,369,0,12327,369,
rw,45,9,314,79,267,12060,346,
goni,45,9,217,176,73,12254,249,
kenett,45,9,50,343,421,11906,764,
fe,45,9,27,366,0,12327,366,
rw,45,10,325,68,293,12034,361,
goni,45,10,227,166,83,12244,249,
kenett,45,10,34,359,437,11890,796,
fe,45,10,30,363,0,12327,363,
rw,45,11,335,58,326,12001,384,
goni,45,11,235,158,105,12222,263,
kenett,45,11,180,213,294,12033,507,
fe,45,11,33,360,0,12327,360,
rw,45,12,346,47,349,11978,396,
goni,45,12,254,139,106,12221,245,
kenett,45,12,185,208,289,12038,497,
fe,45,12,35,358,0,12327,358,
rw,45,13,352,41,375,11952,416,
goni,45,13,267,126,119,12208,245,
kenett,45,13,194,199,280,12047,479,
fe,45,13,38,355,0,12327,355,
rw,45,14,360,33,397,11930,430,
goni,45,14,281,112,140,12187,252,
kenett,45,14,199,194,275,12052,469,
fe,45,14,41,352,0,12327,352,
rw,45,15,366,27,423,11904,450,
goni,45,15,285,108,149,12178,257,
kenett,45,15,212,181,262,12065,443,
fe,45,15,44,349,0,12327,349,
rw,45,16,372,21,446,11881,467,
goni,45,16,299,94,159,12168,253,
kenett,45,16,218,175,256,12071,431,
fe,45,16,46,347,0,12327,347,
rw,45,17,377,16,475,11852,491,
goni,45,17,311,82,175,12152,257,
kenett,45,17,219,174,255,12072,429,
fe,45,17,48,345,0,12327,345,
rw,45,18,379,14,501,11826,515,
goni,45,18,316,77,178,12149,255,
kenett,45,18,218,175,256,12071,431,
fe,45,18,50,343,0,12327,343,
rw,45,19,380,13,521,11806,534,
goni,45,19,322,71,186,12141,257,
kenett,45,19,226,167,248,12079,415,
fe,45,19,53,340,0,12327,340,
rw,45,20,380,13,542,11785,555,
goni,45,20,329,64,199,12128,263,
kenett,45,20,227,166,247,12080,413,
fe,45,20,55,338,0,12327,338,
rw,45,21,380,13,568,11759,581,
goni,45,21,337,56,201,12126,257,
kenett,45,21,235,158,239,12088,397,
fe,45,21,57,336,0,12327,336,
rw,45,22,381,12,588,11739,600,
goni,45,22,341,52,211,12116,263,
kenett,45,22,236,157,238,12089,395,
fe,45,22,60,333,0,12327,333,
rw,45,23,384,9,613,11714,622,
goni,45,23,342,51,222,12105,273,
kenett,45,23,232,161,242,12085,403,
fe,45,23,62,331,0,12327,331,
rw,45,24,385,8,638,11689,646,
goni,45,24,347,46,227,12100,273,
kenett,45,24,232,161,242,12085,403,
fe,45,24,64,329,0,12327,329,
rw,45,25,385,8,659,11668,667,
goni,45,25,353,40,226,12101,266,
kenett,45,25,237,156,237,12090,393,
fe,45,25,67,326,0,12327,326,
rw,45,26,385,8,680,11647,688,
goni,45,26,355,38,236,12091,274,
kenett,45,26,231,162,243,12084,405,
fe,45,26,70,323,0,12327,323,
rw,45,27,386,7,703,11624,710,
goni,45,27,355,38,245,12082,283,
kenett,45,27,248,145,226,12101,371,
fe,45,27,72,321,0,12327,321,
rw,45,28,387,6,725,11602,731,
goni,45,28,357,36,249,12078,285,
kenett,45,28,250,143,224,12103,367,
fe,45,28,75,318,0,12327,318,
rw,45,29,387,6,749,11578,755,
goni,45,29,358,35,253,12074,288,
kenett,45,29,251,142,223,12104,365,
fe,45,29,76,317,0,12327,317,
rw,45,30,387,6,768,11559,774,
goni,45,30,365,28,264,12063,292,
kenett,45,30,251,142,223,12104,365,
fe,45,30,79,314,0,12327,314,
rw,45,31,387,6,784,11543,790,
goni,45,31,363,30,273,12054,303,
kenett,45,31,257,136,217,12110,353,
fe,45,31,82,311,0,12327,311,
rw,45,32,388,5,811,11516,816,
goni,45,32,364,29,288,12039,317,
kenett,45,32,258,135,216,12111,351,
fe,45,32,84,309,0,12327,309,
rw,45,33,388,5,828,11499,833,
goni,45,33,365,28,295,12032,323,
kenett,45,33,264,129,210,12117,339,
fe,45,33,87,306,0,12327,306,
rw,45,34,388,5,840,11487,845,
goni,45,34,369,24,313,12014,337,
kenett,45,34,264,129,210,12117,339,
fe,45,34,88,305,0,12327,305,
rw,45,35,388,5,860,11467,865,
goni,45,35,370,23,315,12012,338,
kenett,45,35,269,124,205,12122,329,
fe,45,35,90,303,0,12327,303,
rw,45,36,388,5,885,11442,890,
goni,45,36,373,20,325,12002,345,
kenett,45,36,265,128,209,12118,337,
fe,45,36,92,301,0,12327,301,
rw,45,37,388,5,907,11420,912,
goni,45,37,375,18,335,11992,353,
kenett,45,37,267,126,207,12120,333,
fe,45,37,95,298,0,12327,298,
rw,45,38,388,5,920,11407,925,
goni,45,38,376,17,344,11983,361,
kenett,45,38,260,133,214,12113,347,
fe,45,38,98,295,0,12327,295,
rw,45,39,389,4,936,11391,940,
goni,45,39,375,18,349,11978,367,
kenett,45,39,262,131,212,12115,343,
fe,45,39,101,292,0,12327,292,
rw,45,40,390,3,955,11372,958,
goni,45,40,376,17,356,11971,373,
kenett,45,40,266,127,208,12119,335,
fe,45,40,104,289,0,12327,289,
rw,45,41,390,3,973,11354,976,
goni,45,41,375,18,363,11964,381,
kenett,45,41,273,120,201,12126,321,
fe,45,41,107,286,0,12327,286,
rw,45,42,390,3,992,11335,995,
goni,45,42,373,20,364,11963,384,
kenett,45,42,263,130,211,12116,341,
fe,45,42,109,284,0,12327,284,
rw,45,43,391,2,1007,11320,1009,
goni,45,43,374,19,370,11957,389,
kenett,45,43,266,127,208,12119,335,
fe,45,43,111,282,0,12327,282,
rw,45,44,391,2,1021,11306,1023,
goni,45,44,376,17,378,11949,395,
kenett,45,44,275,118,199,12128,317,
fe,45,44,112,281,0,12327,281,
rw,45,45,391,2,1036,11291,1038,
goni,45,45,376,17,382,11945,399,
kenett,45,45,277,116,197,12130,313,
fe,45,45,113,280,0,12327,280,
rw,45,46,391,2,1058,11269,1060,
goni,45,46,378,15,391,11936,406,
kenett,45,46,275,118,199,12128,317,
fe,45,46,115,278,0,12327,278,
rw,45,47,391,2,1072,11255,1074,
goni,45,47,379,14,396,11931,410,
kenett,45,47,277,116,197,12130,313,
fe,45,47,116,277,0,12327,277,
rw,45,48,391,2,1084,11243,1086,
goni,45,48,381,12,403,11924,415,
kenett,45,48,270,123,204,12123,327,
fe,45,48,118,275,0,12327,275,
rw,45,49,391,2,1100,11227,1102,
goni,45,49,380,13,408,11919,421,
kenett,45,49,266,127,208,12119,335,
fe,45,49,119,274,0,12327,274,
rw,45,50,391,2,1116,11211,1118,
goni,45,50,381,12,418,11909,430,
kenett,45,50,270,123,204,12123,327,
fe,45,50,122,271,0,12327,271,
rw,46,1,76,317,23,12304,340,
goni,46,1,6,387,1,12326,388,
kenett,46,1,11,382,241,12086,623,
fe,46,1,3,390,0,12327,390,
rw,46,2,131,262,45,12282,307,
goni,46,2,40,353,9,12318,362,
kenett,46,2,10,383,329,11998,712,
fe,46,2,6,387,0,12327,387,
rw,46,3,174,219,87,12240,306,
goni,46,3,68,325,15,12312,340,
kenett,46,3,15,378,393,11934,771,
fe,46,3,9,384,0,12327,384,
rw,46,4,213,180,109,12218,289,
goni,46,4,100,293,32,12295,325,
kenett,46,4,15,378,414,11913,792,
fe,46,4,12,381,0,12327,381,
rw,46,5,239,154,135,12192,289,
goni,46,5,118,275,41,12286,316,
kenett,46,5,14,379,433,11894,812,
fe,46,5,15,378,0,12327,378,
rw,46,6,268,125,163,12164,288,
goni,46,6,156,237,58,12269,295,
kenett,46,6,19,374,440,11887,814,
fe,46,6,18,375,0,12327,375,
rw,46,7,288,105,186,12141,291,
goni,46,7,185,208,69,12258,277,
kenett,46,7,22,371,440,11887,811,
fe,46,7,21,372,0,12327,372,
rw,46,8,307,86,208,12119,294,
goni,46,8,203,190,79,12248,269,
kenett,46,8,20,373,445,11882,818,
fe,46,8,24,369,0,12327,369,
rw,46,9,316,77,238,12089,315,
goni,46,9,209,184,93,12234,277,
kenett,46,9,29,364,442,11885,806,
fe,46,9,26,367,0,12327,367,
rw,46,10,329,64,266,12061,330,
goni,46,10,226,167,110,12217,277,
kenett,46,10,24,369,447,11880,816,
fe,46,10,28,365,0,12327,365,
rw,46,11,335,58,299,12028,357,
goni,46,11,237,156,112,12215,268,
kenett,46,11,24,369,447,11880,816,
fe,46,11,30,363,0,12327,363,
rw,46,12,340,53,329,11998,382,
goni,46,12,256,137,129,12198,266,
kenett,46,12,17,376,454,11873,830,
fe,46,12,32,361,0,12327,361,
rw,46,13,346,47,357,11970,404,
goni,46,13,271,122,133,12194,255,
kenett,46,13,24,369,447,11880,816,
fe,46,13,34,359,0,12327,359,
rw,46,14,348,45,388,11939,433,
goni,46,14,278,115,145,12182,260,
kenett,46,14,197,196,277,12050,473,
fe,46,14,37,356,0,12327,356,
rw,46,15,356,37,416,11911,453,
goni,46,15,285,108,142,12185,250,
kenett,46,15,193,200,281,12046,481,
fe,46,15,40,353,0,12327,353,
rw,46,16,360,33,450,11877,483,
goni,46,16,291,102,167,12160,269,
kenett,46,16,206,187,268,12059,455,
fe,46,16,43,350,0,12327,350,
rw,46,17,368,25,479,11848,504,
goni,46,17,306,87,184,12143,271,
kenett,46,17,206,187,268,12059,455,
fe,46,17,46,347,0,12327,347,
rw,46,18,373,20,501,11826,521,
goni,46,18,306,87,191,12136,278,
kenett,46,18,214,179,260,12067,439,
fe,46,18,49,344,0,12327,344,
rw,46,19,377,16,522,11805,538,
goni,46,19,314,79,198,12129,277,
kenett,46,19,223,170,251,12076,421,
fe,46,19,52,341,0,12327,341,
rw,46,20,379,14,545,11782,559,
goni,46,20,325,68,206,12121,274,
kenett,46,20,222,171,252,12075,423,
fe,46,20,55,338,0,12327,338,
rw,46,21,380,13,572,11755,585,
goni,46,21,324,69,222,12105,291,
kenett,46,21,225,168,249,12078,417,
fe,46,21,58,335,0,12327,335,
rw,46,22,382,11,588,11739,599,
goni,46,22,333,60,223,12104,283,
kenett,46,22,220,173,254,12073,427,
fe,46,22,61,332,0,12327,332,
rw,46,23,385,8,611,11716,619,
goni,46,23,337,56,228,12099,284,
kenett,46,23,229,164,245,12082,409,
fe,46,23,62,331,0,12327,331,
rw,46,24,386,7,641,11686,648,
goni,46,24,339,54,240,12087,294,
kenett,46,24,242,151,232,12095,383,
fe,46,24,65,328,0,12327,328,
rw,46,25,389,4,667,11660,671,
goni,46,25,342,51,254,12073,305,
kenett,46,25,236,157,238,12089,395,
fe,46,25,68,325,0,12327,325,
rw,46,26,389,4,686,11641,690,
goni,46,26,349,44,260,12067,304,
kenett,46,26,230,163,244,12083,407,
fe,46,26,70,323,0,12327,323,
rw,46,27,389,4,706,11621,710,
goni,46,27,350,43,258,12069,301,
kenett,46,27,238,155,236,12091,391,
fe,46,27,72,321,0,12327,321,
rw,46,28,390,3,728,11599,731,
goni,46,28,352,41,267,12060,308,
kenett,46,28,240,153,234,12093,387,
fe,46,28,74,319,0,12327,319,
rw,46,29,391,2,748,11579,750,
goni,46,29,355,38,270,12057,308,
kenett,46,29,242,151,232,12095,383,
fe,46,29,76,317,0,12327,317,
rw,46,30,391,2,769,11558,771,
goni,46,30,362,31,274,12053,305,
kenett,46,30,245,148,229,12098,377,
fe,46,30,79,314,0,12327,314,
rw,46,31,391,2,791,11536,793,
goni,46,31,363,30,287,12040,317,
kenett,46,31,253,140,221,12106,361,
fe,46,31,82,311,0,12327,311,
rw,46,32,391,2,809,11518,811,
goni,46,32,366,27,289,12038,316,
kenett,46,32,245,148,229,12098,377,
fe,46,32,85,308,0,12327,308,
rw,46,33,392,1,825,11502,826,
goni,46,33,367,26,296,12031,322,
kenett,46,33,253,140,221,12106,361,
fe,46,33,88,305,0,12327,305,
rw,46,34,392,1,840,11487,841,
goni,46,34,368,25,304,12023,329,
kenett,46,34,251,142,223,12104,365,
fe,46,34,90,303,0,12327,303,
rw,46,35,392,1,862,11465,863,
goni,46,35,368,25,305,12022,330,
kenett,46,35,251,142,223,12104,365,
fe,46,35,92,301,0,12327,301,
rw,46,36,392,1,886,11441,887,
goni,46,36,367,26,323,12004,349,
kenett,46,36,251,142,223,12104,365,
fe,46,36,94,299,0,12327,299,
rw,46,37,392,1,904,11423,905,
goni,46,37,367,26,331,11996,357,
kenett,46,37,253,140,221,12106,361,
fe,46,37,97,296,0,12327,296,
rw,46,38,392,1,920,11407,921,
goni,46,38,368,25,338,11989,363,
kenett,46,38,251,142,223,12104,365,
fe,46,38,99,294,0,12327,294,
rw,46,39,393,0,944,11383,944,
goni,46,39,369,24,342,11985,366,
kenett,46,39,250,143,224,12103,367,
fe,46,39,102,291,0,12327,291,
rw,46,40,393,0,961,11366,961,
goni,46,40,372,21,351,11976,372,
kenett,46,40,263,130,211,12116,341,
fe,46,40,104,289,0,12327,289,
rw,46,41,393,0,986,11341,986,
goni,46,41,372,21,356,11971,377,
kenett,46,41,258,135,216,12111,351,
fe,46,41,107,286,0,12327,286,
rw,46,42,393,0,1002,11325,1002,
goni,46,42,375,18,366,11961,384,
kenett,46,42,264,129,210,12117,339,
fe,46,42,107,286,0,12327,286,
rw,46,43,393,0,1020,11307,1020,
goni,46,43,375,18,383,11944,401,
kenett,46,43,259,134,215,12112,349,
fe,46,43,108,285,0,12327,285,
rw,46,44,393,0,1037,11290,1037,
goni,46,44,375,18,392,11935,410,
kenett,46,44,256,137,218,12109,355,
fe,46,44,108,285,0,12327,285,
rw,46,45,393,0,1055,11272,1055,
goni,46,45,377,16,394,11933,410,
kenett,46,45,254,139,220,12107,359,
fe,46,45,110,283,0,12327,283,
rw,46,46,393,0,1065,11262,1065,
goni,46,46,378,15,398,11929,413,
kenett,46,46,250,143,224,12103,367,
fe,46,46,113,280,0,12327,280,
rw,46,47,393,0,1082,11245,1082,
goni,46,47,382,11,409,11918,420,
kenett,46,47,251,142,223,12104,365,
fe,46,47,114,279,0,12327,279,
rw,46,48,393,0,1101,11226,1101,
goni,46,48,380,13,401,11926,414,
kenett,46,48,257,136,217,12110,353,
fe,46,48,115,278,0,12327,278,
rw,46,49,393,0,1114,11213,1114,
goni,46,49,381,12,405,11922,417,
kenett,46,49,261,132,213,12114,345,
fe,46,49,116,277,0,12327,277,
rw,46,50,393,0,1135,11192,1135,
goni,46,50,380,13,404,11923,417,
kenett,46,50,273,120,201,12126,321,
fe,46,50,117,276,0,12327,276,
rw,47,1,55,338,42,12285,380,
goni,47,1,10,383,2,12325,385,
kenett,47,1,10,383,221,12106,604,
fe,47,1,3,390,0,12327,390,
rw,47,2,107,286,76,12251,362,
goni,47,2,25,368,13,12314,381,
kenett,47,2,9,384,312,12015,696,
fe,47,2,6,387,0,12327,387,
rw,47,3,155,238,105,12222,343,
goni,47,3,54,339,21,12306,360,
kenett,47,3,10,383,362,11965,745,
fe,47,3,9,384,0,12327,384,
rw,47,4,199,194,134,12193,328,
goni,47,4,81,312,32,12295,344,
kenett,47,4,14,379,412,11915,791,
fe,47,4,12,381,0,12327,381,
rw,47,5,231,162,161,12166,323,
goni,47,5,108,285,46,12281,331,
kenett,47,5,18,375,429,11898,804,
fe,47,5,15,378,0,12327,378,
rw,47,6,267,126,186,12141,312,
goni,47,6,136,257,51,12276,308,
kenett,47,6,17,376,436,11891,812,
fe,47,6,18,375,0,12327,375,
rw,47,7,289,104,215,12112,319,
goni,47,7,162,231,68,12259,299,
kenett,47,7,15,378,441,11886,819,
fe,47,7,21,372,0,12327,372,
rw,47,8,306,87,245,12082,332,
goni,47,8,179,214,72,12255,286,
kenett,47,8,17,376,442,11885,818,
fe,47,8,24,369,0,12327,369,
rw,47,9,318,75,275,12052,350,
goni,47,9,196,197,77,12250,274,
kenett,47,9,11,382,451,11876,833,
fe,47,9,27,366,0,12327,366,
rw,47,10,329,64,295,12032,359,
goni,47,10,223,170,88,12239,258,
kenett,47,10,16,377,446,11881,823,
fe,47,10,29,364,0,12327,364,
rw,47,11,340,53,321,12006,374,
goni,47,11,239,154,94,12233,248,
kenett,47,11,21,372,444,11883,816,
fe,47,11,32,361,0,12327,361,
rw,47,12,346,47,347,11980,394,
goni,47,12,243,150,102,12225,252,
kenett,47,12,20,373,448,11879,821,
fe,47,12,35,358,0,12327,358,
rw,47,13,351,42,372,11955,414,
goni,47,13,250,143,109,12218,252,
kenett,47,13,21,372,447,11880,819,
fe,47,13,38,355,0,12327,355,
rw,47,14,358,35,400,11927,435,
goni,47,14,268,125,125,12202,250,
kenett,47,14,58,335,413,11914,748,
fe,47,14,41,352,0,12327,352,
rw,47,15,361,32,418,11909,450,
goni,47,15,274,119,133,12194,252,
kenett,47,15,56,337,415,11912,752,
fe,47,15,42,351,0,12327,351,
rw,47,16,366,27,449,11878,476,
goni,47,16,287,106,152,12175,258,
kenett,47,16,47,346,424,11903,770,
fe,47,16,45,348,0,12327,348,
rw,47,17,370,23,478,11849,501,
goni,47,17,292,101,163,12164,264,
kenett,47,17,46,347,425,11902,772,
fe,47,17,48,345,0,12327,345,
rw,47,18,371,22,500,11827,522,
goni,47,18,302,91,174,12153,265,
kenett,47,18,33,360,438,11889,798,
fe,47,18,51,342,0,12327,342,
rw,47,19,372,21,523,11804,544,
goni,47,19,309,84,184,12143,268,
kenett,47,19,46,347,425,11902,772,
fe,47,19,54,339,0,12327,339,
rw,47,20,377,16,546,11781,562,
goni,47,20,315,78,201,12126,279,
kenett,47,20,45,348,426,11901,774,
fe,47,20,56,337,0,12327,337,
rw,47,21,379,14,566,11761,580,
goni,47,21,318,75,212,12115,287,
kenett,47,21,40,353,431,11896,784,
fe,47,21,58,335,0,12327,335,
rw,47,22,382,11,584,11743,595,
goni,47,22,329,64,218,12109,282,
kenett,47,22,224,169,250,12077,419,
fe,47,22,60,333,0,12327,333,
rw,47,23,382,11,613,11714,624,
goni,47,23,332,61,221,12106,282,
kenett,47,23,221,172,253,12074,425,
fe,47,23,62,331,0,12327,331,
rw,47,24,384,9,635,11692,644,
goni,47,24,340,53,231,12096,284,
kenett,47,24,240,153,234,12093,387,
fe,47,24,65,328,0,12327,328,
rw,47,25,384,9,657,11670,666,
goni,47,25,342,51,237,12090,288,
kenett,47,25,242,151,232,12095,383,
fe,47,25,67,326,0,12327,326,
rw,47,26,386,7,679,11648,686,
goni,47,26,344,49,241,12086,290,
kenett,47,26,243,150,231,12096,381,
fe,47,26,69,324,0,12327,324,
rw,47,27,388,5,695,11632,700,
goni,47,27,349,44,245,12082,289,
kenett,47,27,258,135,216,12111,351,
fe,47,27,72,321,0,12327,321,
rw,47,28,388,5,716,11611,721,
goni,47,28,356,37,261,12066,298,
kenett,47,28,246,147,228,12099,375,
fe,47,28,75,318,0,12327,318,
rw,47,29,390,3,742,11585,745,
goni,47,29,361,32,256,12071,288,
kenett,47,29,252,141,222,12105,363,
fe,47,29,78,315,0,12327,315,
rw,47,30,390,3,758,11569,761,
goni,47,30,359,34,265,12062,299,
kenett,47,30,253,140,221,12106,361,
fe,47,30,80,313,0,12327,313,
rw,47,31,390,3,777,11550,780,
goni,47,31,361,32,271,12056,303,
kenett,47,31,253,140,221,12106,361,
fe,47,31,81,312,0,12327,312,
rw,47,32,390,3,795,11532,798,
goni,47,32,364,29,273,12054,302,
kenett,47,32,259,134,215,12112,349,
fe,47,32,83,310,0,12327,310,
rw,47,33,391,2,816,11511,818,
goni,47,33,364,29,283,12044,312,
kenett,47,33,255,138,219,12108,357,
fe,47,33,85,308,0,12327,308,
rw,47,34,391,2,840,11487,842,
goni,47,34,367,26,288,12039,314,
kenett,47,34,251,142,223,12104,365,
fe,47,34,88,305,0,12327,305,
rw,47,35,391,2,861,11466,863,
goni,47,35,368,25,288,12039,313,
kenett,47,35,244,149,230,12097,379,
fe,47,35,89,304,0,12327,304,
rw,47,36,392,1,879,11448,880,
goni,47,36,370,23,286,12041,309,
kenett,47,36,249,144,225,12102,369,
fe,47,36,92,301,0,12327,301,
rw,47,37,392,1,893,11434,894,
goni,47,37,372,21,289,12038,310,
kenett,47,37,250,143,224,12103,367,
fe,47,37,94,299,0,12327,299,
rw,47,38,392,1,906,11421,907,
goni,47,38,373,20,300,12027,320,
kenett,47,38,252,141,222,12105,363,
fe,47,38,96,297,0,12327,297,
rw,47,39,392,1,927,11400,928,
goni,47,39,373,20,308,12019,328,
kenett,47,39,261,132,213,12114,345,
fe,47,39,99,294,0,12327,294,
rw,47,40,392,1,951,11376,952,
goni,47,40,374,19,319,12008,338,
kenett,47,40,260,133,214,12113,347,
fe,47,40,102,291,0,12327,291,
rw,47,41,393,0,966,11361,966,
goni,47,41,377,16,322,12005,338,
kenett,47,41,261,132,213,12114,345,
fe,47,41,105,288,0,12327,288,
rw,47,42,393,0,990,11337,990,
goni,47,42,380,13,321,12006,334,
kenett,47,42,258,135,216,12111,351,
fe,47,42,106,287,0,12327,287,
rw,47,43,393,0,1005,11322,1005,
goni,47,43,378,15,325,12002,340,
kenett,47,43,263,130,211,12116,341,
fe,47,43,109,284,0,12327,284,
rw,47,44,393,0,1028,11299,1028,
goni,47,44,383,10,334,11993,344,
kenett,47,44,265,128,209,12118,337,
fe,47,44,111,282,0,12327,282,
rw,47,45,393,0,1047,11280,1047,
goni,47,45,384,9,331,11996,340,
kenett,47,45,261,132,213,12114,345,
fe,47,45,112,281,0,12327,281,
rw,47,46,393,0,1065,11262,1065,
goni,47,46,385,8,349,11978,357,
kenett,47,46,261,132,213,12114,345,
fe,47,46,115,278,0,12327,278,
rw,47,47,393,0,1085,11242,1085,
goni,47,47,386,7,353,11974,360,
kenett,47,47,258,135,216,12111,351,
fe,47,47,116,277,0,12327,277,
rw,47,48,393,0,1105,11222,1105,
goni,47,48,385,8,354,11973,362,
kenett,47,48,267,126,207,12120,333,
fe,47,48,116,277,0,12327,277,
rw,47,49,393,0,1126,11201,1126,
goni,47,49,384,9,364,11963,373,
kenett,47,49,265,128,209,12118,337,
fe,47,49,117,276,0,12327,276,
rw,47,50,393,0,1143,11184,1143,
goni,47,50,385,8,367,11960,375,
kenett,47,50,269,124,205,12122,329,
fe,47,50,120,273,0,12327,273,
rw,48,1,66,327,34,12293,361,
goni,48,1,5,388,3,12324,391,
kenett,48,1,17,376,199,12128,575,
fe,48,1,3,390,0,12327,390,
rw,48,2,124,269,65,12262,334,
goni,48,2,26,367,9,12318,376,
kenett,48,2,19,374,296,12031,670,
fe,48,2,6,387,0,12327,387,
rw,48,3,169,224,92,12235,316,
goni,48,3,51,342,20,12307,362,
kenett,48,3,18,375,366,11961,741,
fe,48,3,9,384,0,12327,384,
rw,48,4,210,183,119,12208,302,
goni,48,4,84,309,29,12298,338,
kenett,48,4,19,374,410,11917,784,
fe,48,4,12,381,0,12327,381,
rw,48,5,242,151,146,12181,297,
goni,48,5,117,276,41,12286,317,
kenett,48,5,20,373,424,11903,797,
fe,48,5,15,378,0,12327,378,
rw,48,6,267,126,183,12144,309,
goni,48,6,137,256,59,12268,315,
kenett,48,6,19,374,449,11878,823,
fe,48,6,17,376,0,12327,376,
rw,48,7,286,107,210,12117,317,
goni,48,7,164,229,67,12260,296,
kenett,48,7,19,374,449,11878,823,
fe,48,7,20,373,0,12327,373,
rw,48,8,301,92,237,12090,329,
goni,48,8,180,213,77,12250,290,
kenett,48,8,18,375,450,11877,825,
fe,48,8,23,370,0,12327,370,
rw,48,9,314,79,274,12053,353,
goni,48,9,199,194,95,12232,289,
kenett,48,9,21,372,450,11877,822,
fe,48,9,26,367,0,12327,367,
rw,48,10,323,70,299,12028,369,
goni,48,10,216,177,118,12209,295,
kenett,48,10,23,370,448,11879,818,
fe,48,10,28,365,0,12327,365,
rw,48,11,331,62,326,12001,388,
goni,48,11,235,158,126,12201,284,
kenett,48,11,29,364,442,11885,806,
fe,48,11,31,362,0,12327,362,
rw,48,12,337,56,347,11980,403,
goni,48,12,253,140,137,12190,277,
kenett,48,12,184,209,290,12037,499,
fe,48,12,34,359,0,12327,359,
rw,48,13,345,48,376,11951,424,
goni,48,13,258,135,140,12187,275,
kenett,48,13,192,201,282,12045,483,
fe,48,13,36,357,0,12327,357,
rw,48,14,353,40,407,11920,447,
goni,48,14,268,125,152,12175,277,
kenett,48,14,192,201,282,12045,483,
fe,48,14,39,354,0,12327,354,
rw,48,15,359,34,431,11896,465,
goni,48,15,279,114,166,12161,280,
kenett,48,15,202,191,272,12055,463,
fe,48,15,42,351,0,12327,351,
rw,48,16,365,28,454,11873,482,
goni,48,16,291,102,181,12146,283,
kenett,48,16,208,185,266,12061,451,
fe,48,16,44,349,0,12327,349,
rw,48,17,370,23,471,11856,494,
goni,48,17,294,99,196,12131,295,
kenett,48,17,216,177,258,12069,435,
fe,48,17,47,346,0,12327,346,
rw,48,18,374,19,496,11831,515,
goni,48,18,303,90,207,12120,297,
kenett,48,18,217,176,257,12070,433,
fe,48,18,50,343,0,12327,343,
rw,48,19,376,17,518,11809,535,
goni,48,19,313,80,220,12107,300,
kenett,48,19,216,177,258,12069,435,
fe,48,19,53,340,0,12327,340,
rw,48,20,378,15,537,11790,552,
goni,48,20,316,77,221,12106,298,
kenett,48,20,217,176,257,12070,433,
fe,48,20,55,338,0,12327,338,
rw,48,21,380,13,556,11771,569,
goni,48,21,321,72,224,12103,296,
kenett,48,21,222,171,252,12075,423,
fe,48,21,57,336,0,12327,336,
rw,48,22,380,13,576,11751,589,
goni,48,22,323,70,227,12100,297,
kenett,48,22,223,170,251,12076,421,
fe,48,22,59,334,0,12327,334,
rw,48,23,382,11,594,11733,605,
goni,48,23,328,65,239,12088,304,
kenett,48,23,230,163,244,12083,407,
fe,48,23,60,333,0,12327,333,
rw,48,24,382,11,615,11712,626,
goni,48,24,334,59,240,12087,299,
kenett,48,24,231,162,243,12084,405,
fe,48,24,63,330,0,12327,330,
rw,48,25,384,9,630,11697,639,
goni,48,25,342,51,248,12079,299,
kenett,48,25,238,155,236,12091,391,
fe,48,25,66,327,0,12327,327,
rw,48,26,385,8,651,11676,659,
goni,48,26,344,49,261,12066,310,
kenett,48,26,234,159,240,12087,399,
fe,48,26,68,325,0,12327,325,
rw,48,27,389,4,672,11655,676,
goni,48,27,351,42,268,12059,310,
kenett,48,27,245,148,229,12098,377,
fe,48,27,70,323,0,12327,323,
rw,48,28,389,4,700,11627,704,
goni,48,28,349,44,285,12042,329,
kenett,48,28,237,156,237,12090,393,
fe,48,28,73,320,0,12327,320,
rw,48,29,389,4,722,11605,726,
goni,48,29,353,40,283,12044,323,
kenett,48,29,245,148,229,12098,377,
fe,48,29,76,317,0,12327,317,
rw,48,30,390,3,746,11581,749,
goni,48,30,352,41,289,12038,330,
kenett,48,30,242,151,232,12095,383,
fe,48,30,79,314,0,12327,314,
rw,48,31,390,3,770,11557,773,
goni,48,31,358,35,302,12025,337,
kenett,48,31,239,154,235,12092,389,
fe,48,31,82,311,0,12327,311,
rw,48,32,390,3,797,11530,800,
goni,48,32,360,33,306,12021,339,
kenett,48,32,248,145,226,12101,371,
fe,48,32,84,309,0,12327,309,
rw,48,33,390,3,811,11516,814,
goni,48,33,366,27,312,12015,339,
kenett,48,33,248,145,226,12101,371,
fe,48,33,87,306,0,12327,306,
rw,48,34,390,3,832,11495,835,
goni,48,34,368,25,318,12009,343,
kenett,48,34,254,139,220,12107,359,
fe,48,34,90,303,0,12327,303,
rw,48,35,391,2,848,11479,850,
goni,48,35,369,24,328,11999,352,
kenett,48,35,248,145,226,12101,371,
fe,48,35,93,300,0,12327,300,
rw,48,36,392,1,864,11463,865,
goni,48,36,369,24,329,11998,353,
kenett,48,36,259,134,215,12112,349,
fe,48,36,96,297,0,12327,297,
rw,48,37,392,1,880,11447,881,
goni,48,37,371,22,331,11996,353,
kenett,48,37,258,135,216,12111,351,
fe,48,37,97,296,0,12327,296,
rw,48,38,392,1,904,11423,905,
goni,48,38,373,20,332,11995,352,
kenett,48,38,250,143,224,12103,367,
fe,48,38,99,294,0,12327,294,
rw,48,39,392,1,925,11402,926,
goni,48,39,375,18,338,11989,356,
kenett,48,39,250,143,224,12103,367,
fe,48,39,102,291,0,12327,291,
rw,48,40,392,1,938,11389,939,
goni,48,40,374,19,350,11977,369,
kenett,48,40,251,142,223,12104,365,
fe,48,40,105,288,0,12327,288,
rw,48,41,392,1,957,11370,958,
goni,48,41,375,18,358,11969,376,
kenett,48,41,254,139,220,12107,359,
fe,48,41,106,287,0,12327,287,
rw,48,42,392,1,975,11352,976,
goni,48,42,375,18,374,11953,392,
kenett,48,42,265,128,209,12118,337,
fe,48,42,107,286,0,12327,286,
rw,48,43,392,1,995,11332,996,
goni,48,43,375,18,379,11948,397,
kenett,48,43,270,123,204,12123,327,
fe,48,43,110,283,0,12327,283,
rw,48,44,392,1,1008,11319,1009,
goni,48,44,376,17,389,11938,406,
kenett,48,44,268,125,206,12121,331,
fe,48,44,113,280,0,12327,280,
rw,48,45,392,1,1028,11299,1029,
goni,48,45,376,17,404,11923,421,
kenett,48,45,274,119,200,12127,319,
fe,48,45,116,277,0,12327,277,
rw,48,46,392,1,1042,11285,1043,
goni,48,46,377,16,405,11922,421,
kenett,48,46,269,124,205,12122,329,
fe,48,46,118,275,0,12327,275,
rw,48,47,392,1,1058,11269,1059,
goni,48,47,377,16,415,11912,431,
kenett,48,47,265,128,209,12118,337,
fe,48,47,121,272,0,12327,272,
rw,48,48,392,1,1067,11260,1068,
goni,48,48,378,15,416,11911,431,
kenett,48,48,269,124,205,12122,329,
fe,48,48,124,269,0,12327,269,
rw,48,49,392,1,1094,11233,1095,
goni,48,49,380,13,415,11912,428,
kenett,48,49,268,125,206,12121,331,
fe,48,49,126,267,0,12327,267,
rw,48,50,392,1,1112,11215,1113,
goni,48,50,383,10,416,11911,426,
kenett,48,50,271,122,203,12124,325,
fe,48,50,129,264,0,12327,264,
rw,49,1,74,319,25,12302,344,
goni,49,1,5,388,2,12325,390,
kenett,49,1,14,379,226,12101,605,
fe,49,1,3,390,0,12327,390,
rw,49,2,131,262,52,12275,314,
goni,49,2,34,359,6,12321,365,
kenett,49,2,17,376,349,11978,725,
fe,49,2,6,387,0,12327,387,
rw,49,3,185,208,70,12257,278,
goni,49,3,75,318,14,12313,332,
kenett,49,3,21,372,384,11943,756,
fe,49,3,9,384,0,12327,384,
rw,49,4,221,172,105,12222,277,
goni,49,4,100,293,30,12297,323,
kenett,49,4,15,378,417,11910,795,
fe,49,4,12,381,0,12327,381,
rw,49,5,244,149,135,12192,284,
goni,49,5,123,270,38,12289,308,
kenett,49,5,22,371,428,11899,799,
fe,49,5,15,378,0,12327,378,
rw,49,6,267,126,164,12163,290,
goni,49,6,146,247,52,12275,299,
kenett,49,6,21,372,432,11895,804,
fe,49,6,18,375,0,12327,375,
rw,49,7,289,104,190,12137,294,
goni,49,7,177,216,62,12265,278,
kenett,49,7,21,372,435,11892,807,
fe,49,7,21,372,0,12327,372,
rw,49,8,301,92,227,12100,319,
goni,49,8,188,205,72,12255,277,
kenett,49,8,13,380,449,11878,829,
fe,49,8,24,369,0,12327,369,
rw,49,9,314,79,261,12066,340,
goni,49,9,199,194,79,12248,273,
kenett,49,9,18,375,447,11880,822,
fe,49,9,27,366,0,12327,366,
rw,49,10,327,66,291,12036,357,
goni,49,10,214,179,98,12229,277,
kenett,49,10,17,376,454,11873,830,
fe,49,10,30,363,0,12327,363,
rw,49,11,339,54,316,12011,370,
goni,49,11,236,157,107,12220,264,
kenett,49,11,187,206,287,12040,493,
fe,49,11,33,360,0,12327,360,
rw,49,12,348,45,352,11975,397,
goni,49,12,254,139,125,12202,264,
kenett,49,12,202,191,272,12055,463,
fe,49,12,36,357,0,12327,357,
rw,49,13,354,39,371,11956,410,
goni,49,13,270,123,125,12202,248,
kenett,49,13,207,186,267,12060,453,
fe,49,13,39,354,0,12327,354,
rw,49,14,360,33,393,11934,426,
goni,49,14,282,111,132,12195,243,
kenett,49,14,199,194,275,12052,469,
fe,49,14,42,351,0,12327,351,
rw,49,15,368,25,423,11904,448,
goni,49,15,288,105,136,12191,241,
kenett,49,15,206,187,268,12059,455,
fe,49,15,44,349,0,12327,349,
rw,49,16,369,24,453,11874,477,
goni,49,16,292,101,153,12174,254,
kenett,49,16,213,180,261,12066,441,
fe,49,16,47,346,0,12327,346,
rw,49,17,370,23,477,11850,500,
goni,49,17,300,93,157,12170,250,
kenett,49,17,223,170,251,12076,421,
fe,49,17,50,343,0,12327,343,
rw,49,18,374,19,501,11826,520,
goni,49,18,309,84,166,12161,250,
kenett,49,18,222,171,252,12075,423,
fe,49,18,51,342,0,12327,342,
rw,49,19,377,16,520,11807,536,
goni,49,19,312,81,162,12165,243,
kenett,49,19,218,175,256,12071,431,
fe,49,19,54,339,0,12327,339,
rw,49,20,379,14,535,11792,549,
goni,49,20,319,74,183,12144,257,
kenett,49,20,230,163,244,12083,407,
fe,49,20,56,337,0,12327,337,
rw,49,21,384,9,552,11775,561,
goni,49,21,320,73,194,12133,267,
kenett,49,21,225,168,249,12078,417,
fe,49,21,59,334,0,12327,334,
rw,49,22,386,7,578,11749,585,
goni,49,22,330,63,206,12121,269,
kenett,49,22,229,164,245,12082,409,
fe,49,22,62,331,0,12327,331,
rw,49,23,386,7,599,11728,606,
goni,49,23,336,57,217,12110,274,
kenett,49,23,235,158,239,12088,397,
fe,49,23,64,329,0,12327,329,
rw,49,24,387,6,618,11709,624,
goni,49,24,344,49,224,12103,273,
kenett,49,24,247,146,227,12100,373,
fe,49,24,67,326,0,12327,326,
rw,49,25,387,6,640,11687,646,
goni,49,25,346,47,225,12102,272,
kenett,49,25,247,146,227,12100,373,
fe,49,25,70,323,0,12327,323,
rw,49,26,387,6,665,11662,671,
goni,49,26,351,42,232,12095,274,
kenett,49,26,246,147,228,12099,375,
fe,49,26,73,320,0,12327,320,
rw,49,27,387,6,684,11643,690,
goni,49,27,351,42,236,12091,278,
kenett,49,27,241,152,233,12094,385,
fe,49,27,76,317,0,12327,317,
rw,49,28,387,6,707,11620,713,
goni,49,28,356,37,249,12078,286,
kenett,49,28,243,150,231,12096,381,
fe,49,28,78,315,0,12327,315,
rw,49,29,388,5,724,11603,729,
goni,49,29,358,35,251,12076,286,
kenett,49,29,245,148,229,12098,377,
fe,49,29,81,312,0,12327,312,
rw,49,30,390,3,741,11586,744,
goni,49,30,361,32,263,12064,295,
kenett,49,30,252,141,222,12105,363,
fe,49,30,84,309,0,12327,309,
rw,49,31,391,2,758,11569,760,
goni,49,31,362,31,270,12057,301,
kenett,49,31,257,136,217,12110,353,
fe,49,31,86,307,0,12327,307,
rw,49,32,392,1,784,11543,785,
goni,49,32,357,36,282,12045,318,
kenett,49,32,253,140,221,12106,361,
fe,49,32,89,304,0,12327,304,
rw,49,33,392,1,804,11523,805,
goni,49,33,360,33,289,12038,322,
kenett,49,33,251,142,223,12104,365,
fe,49,33,91,302,0,12327,302,
rw,49,34,392,1,822,11505,823,
goni,49,34,362,31,286,12041,317,
kenett,49,34,251,142,223,12104,365,
fe,49,34,94,299,0,12327,299,
rw,49,35,392,1,841,11486,842,
goni,49,35,363,30,300,12027,330,
kenett,49,35,251,142,223,12104,365,
fe,49,35,96,297,0,12327,297,
rw,49,36,392,1,854,11473,855,
goni,49,36,368,25,295,12032,320,
kenett,49,36,258,135,216,12111,351,
fe,49,36,98,295,0,12327,295,
rw,49,37,392,1,869,11458,870,
goni,49,37,372,21,309,12018,330,
kenett,49,37,258,135,216,12111,351,
fe,49,37,100,293,0,12327,293,
rw,49,38,392,1,894,11433,895,
goni,49,38,373,20,315,12012,335,
kenett,49,38,258,135,216,12111,351,
fe,49,38,101,292,0,12327,292,
rw,49,39,392,1,912,11415,913,
goni,49,39,375,18,321,12006,339,
kenett,49,39,262,131,212,12115,343,
fe,49,39,104,289,0,12327,289,
rw,49,40,392,1,939,11388,940,
goni,49,40,377,16,327,12000,343,
kenett,49,40,260,133,214,12113,347,
fe,49,40,106,287,0,12327,287,
rw,49,41,392,1,956,11371,957,
goni,49,41,377,16,331,11996,347,
kenett,49,41,261,132,213,12114,345,
fe,49,41,109,284,0,12327,284,
rw,49,42,392,1,978,11349,979,
goni,49,42,378,15,337,11990,352,
kenett,49,42,265,128,209,12118,337,
fe,49,42,111,282,0,12327,282,
rw,49,43,392,1,1001,11326,1002,
goni,49,43,378,15,339,11988,354,
kenett,49,43,266,127,208,12119,335,
fe,49,43,114,279,0,12327,279,
rw,49,44,392,1,1015,11312,1016,
goni,49,44,379,14,350,11977,364,
kenett,49,44,266,127,208,12119,335,
fe,49,44,116,277,0,12327,277,
rw,49,45,392,1,1025,11302,1026,
goni,49,45,377,16,353,11974,369,
kenett,49,45,269,124,205,12122,329,
fe,49,45,119,274,0,12327,274,
rw,49,46,392,1,1042,11285,1043,
goni,49,46,380,13,363,11964,376,
kenett,49,46,273,120,201,12126,321,
fe,49,46,121,272,0,12327,272,
rw,49,47,393,0,1054,11273,1054,
goni,49,47,381,12,363,11964,375,
kenett,49,47,271,122,203,12124,325,
fe,49,47,124,269,0,12327,269,
rw,49,48,393,0,1065,11262,1065,
goni,49,48,381,12,365,11962,377,
kenett,49,48,268,125,206,12121,331,
fe,49,48,126,267,0,12327,267,
rw,49,49,393,0,1073,11254,1073,
goni,49,49,382,11,381,11946,392,
kenett,49,49,268,125,206,12121,331,
fe,49,49,127,266,0,12327,266,
rw,49,50,393,0,1092,11235,1092,
goni,49,50,383,10,389,11938,399,
kenett,49,50,270,123,204,12123,327,
fe,49,50,129,264,0,12327,264,
chan,0,1,67,326,22,12305,348,0
chan,0,2,100,293,35,12292,328,0
chan,0,3,122,271,48,12279,319,0
chan,0,4,123,270,64,12263,334,0
chan,0,5,126,267,69,12258,336,0
chan,0,6,118,275,60,12267,335,0
chan,0,7,123,270,51,12276,321,0
chan,0,8,129,264,40,12287,304,0
chan,0,9,128,265,43,12284,308,0
chan,0,10,133,260,38,12289,298,0
chan,0,11,130,263,41,12286,304,0
chan,0,12,136,257,35,12292,292,0
chan,0,13,137,256,27,12300,283,0
chan,0,14,136,257,27,12300,284,0
chan,0,15,137,256,29,12298,285,0
chan,0,16,139,254,27,12300,281,0
chan,0,17,142,251,24,12303,275,0
chan,0,18,146,247,19,12308,266,0
chan,0,19,144,249,19,12308,268,0
chan,0,20,142,251,19,12308,270,0
chan,0,21,144,249,16,12311,265,0
chan,0,22,145,248,14,12313,262,0
chan,0,23,146,247,13,12314,260,0
chan,0,24,148,245,12,12315,257,0
chan,0,25,146,247,13,12314,260,0
chan,0,26,150,243,10,12317,253,0
chan,0,27,150,243,9,12318,252,0
chan,0,28,150,243,9,12318,252,0
chan,0,29,150,243,9,12318,252,0
chan,0,30,150,243,9,12318,252,0
chan,0,31,148,245,11,12316,256,0
chan,0,32,151,242,8,12319,250,0
chan,0,33,150,243,9,12318,252,0
chan,0,34,151,242,8,12319,250,0
chan,0,35,151,242,8,12319,250,0
chan,0,36,151,242,8,12319,250,0
chan,0,37,151,242,8,12319,250,0
chan,0,38,151,242,8,12319,250,0
chan,0,39,151,242,8,12319,250,0
chan,0,40,150,243,9,12318,252,0
chan,0,41,152,241,8,12319,249,0
chan,0,42,150,243,9,12318,252,0
chan,0,43,150,243,9,12318,252,0
chan,0,44,150,243,9,12318,252,0
chan,0,45,151,242,8,12319,250,0
chan,0,46,151,242,8,12319,250,0
chan,0,47,152,241,7,12320,248,0
chan,0,48,152,241,7,12320,248,0
chan,0,49,152,241,7,12320,248,0
chan,0,50,153,240,6,12321,246,0
chan,1,1,58,335,27,12300,362,150
chan,1,2,89,304,48,12279,352,150
chan,1,3,100,293,67,12260,360,150
chan,1,4,111,282,83,12244,365,150
chan,1,5,119,274,86,12241,360,150
chan,1,6,120,273,88,12239,361,150
chan,1,7,120,273,74,12253,347,150
chan,1,8,121,272,67,12260,339,150
chan,1,9,124,269,66,12261,335,150
chan,1,10,127,266,60,12267,326,150
chan,1,11,125,268,63,12264,331,150
chan,1,12,131,262,61,12266,323,150
chan,1,13,130,263,55,12272,318,150
chan,1,14,131,262,45,12282,307,150
chan,1,15,134,259,35,12292,294,150
chan,1,16,133,260,35,12292,295,150
chan,1,17,135,258,31,12296,289,150
chan,1,18,137,256,30,12297,286,150
chan,1,19,135,258,31,12296,289,150
chan,1,20,137,256,29,12298,285,150
chan,1,21,137,256,30,12297,286,150
chan,1,22,141,252,27,12300,279,150
chan,1,23,142,251,23,12304,274,150
chan,1,24,141,252,23,12304,275,150
chan,1,25,142,251,22,12305,273,150
chan,1,26,142,251,20,12307,271,150
chan,1,27,144,249,18,12309,267,150
chan,1,28,144,249,16,12311,265,150
chan,1,29,144,249,15,12312,264,150
chan,1,30,146,247,13,12314,260,150
chan,1,31,147,246,12,12315,258,150
chan,1,32,148,245,11,12316,256,150
chan,1,33,148,245,11,12316,256,150
chan,1,34,148,245,11,12316,256,150
chan,1,35,150,243,9,12318,252,150
chan,1,36,152,241,7,12320,248,150
chan,1,37,152,241,7,12320,248,150
chan,1,38,152,241,7,12320,248,150
chan,1,39,151,242,8,12319,250,150
chan,1,40,151,242,8,12319,250,150
chan,1,41,149,244,11,12316,255,150
chan,1,42,148,245,11,12316,256,150
chan,1,43,147,246,12,12315,258,150
chan,1,44,147,246,12,12315,258,150
chan,1,45,147,246,12,12315,258,150
chan,1,46,149,244,10,12317,254,150
chan,1,47,150,243,10,12317,253,150
chan,1,48,151,242,9,12318,251,150
chan,1,49,152,241,7,12320,248,150
chan,1,50,154,239,5,12322,244,150
chan,2,1,66,327,25,12302,352,300
chan,2,2,105,288,40,12287,328,300
chan,2,3,122,271,53,12274,324,300
chan,2,4,125,268,65,12262,333,300
chan,2,5,129,264,68,12259,332,300
chan,2,6,122,271,69,12258,340,300
chan,2,7,123,270,58,12269,328,300
chan,2,8,127,266,51,12276,317,300
chan,2,9,131,262,41,12286,303,300
chan,2,10,124,269,43,12284,312,300
chan,2,11,124,269,39,12288,308,300
chan,2,12,125,268,42,12285,310,300
chan,2,13,133,260,35,12292,295,300
chan,2,14,133,260,28,12299,288,300
chan,2,15,136,257,26,12301,283,300
chan,2,16,139,254,22,12305,276,300
chan,2,17,138,255,22,12305,277,300
chan,2,18,138,255,22,12305,277,300
chan,2,19,137,256,23,12304,279,300
chan,2,20,138,255,23,12304,278,300
chan,2,21,140,253,20,12307,273,300
chan,2,22,143,250,17,12310,267,300
chan,2,23,144,249,16,12311,265,300
chan,2,24,144,249,16,12311,265,300
chan,2,25,143,250,17,12310,267,300
chan,2,26,143,250,17,12310,267,300
chan,2,27,146,247,13,12314,260,300
chan,2,28,147,246,12,12315,258,300
chan,2,29,147,246,12,12315,258,300
chan,2,30,147,246,12,12315,258,300
chan,2,31,147,246,12,12315,258,300
chan,2,32,145,248,14,12313,262,300
chan,2,33,147,246,12,12315,258,300
chan,2,34,145,248,14,12313,262,300
chan,2,35,145,248,14,12313,262,300
chan,2,36,146,247,13,12314,260,300
chan,2,37,146,247,13,12314,260,300
chan,2,38,148,245,11,12316,256,300
chan,2,39,149,244,10,12317,254,300
chan,2,40,147,246,12,12315,258,300
chan,2,41,149,244,10,12317,254,300
chan,2,42,150,243,9,12318,252,300
chan,2,43,150,243,9,12318,252,300
chan,2,44,151,242,8,12319,250,300
chan,2,45,151,242,8,12319,250,300
chan,2,46,151,242,8,12319,250,300
chan,2,47,152,241,8,12319,249,300
chan,2,48,152,241,8,12319,249,300
chan,2,49,152,241,8,12319,249,300
chan,2,50,153,240,7,12320,247,300
chan,3,1,54,339,25,12302,364,450
chan,3,2,92,301,42,12285,343,450
chan,3,3,108,285,56,12271,341,450
chan,3,4,124,269,58,12269,327,450
chan,3,5,130,263,69,12258,332,450
chan,3,6,124,269,64,12263,333,450
chan,3,7,136,257,55,12272,312,450
chan,3,8,131,262,50,12277,312,450
chan,3,9,136,257,46,12281,303,450
chan,3,10,140,253,44,12283,297,450
chan,3,11,136,257,39,12288,296,450
chan,3,12,141,252,36,12291,288,450
chan,3,13,136,257,35,12292,292,450
chan,3,14,137,256,32,12295,288,450
chan,3,15,136,257,33,12294,290,450
chan,3,16,138,255,27,12300,282,450
chan,3,17,140,253,24,12303,277,450
chan,3,18,141,252,21,12306,273,450
chan,3,19,143,250,19,12308,269,450
chan,3,20,141,252,21,12306,273,450
chan,3,21,141,252,21,12306,273,450
chan,3,22,138,255,24,12303,279,450
chan,3,23,138,255,22,12305,277,450
chan,3,24,141,252,21,12306,273,450
chan,3,25,141,252,21,12306,273,450
chan,3,26,142,251,20,12307,271,450
chan,3,27,141,252,20,12307,272,450
chan,3,28,143,250,18,12309,268,450
chan,3,29,142,251,19,12308,270,450
chan,3,30,140,253,21,12306,274,450
chan,3,31,140,253,21,12306,274,450
chan,3,32,140,253,21,12306,274,450
chan,3,33,141,252,20,12307,272,450
chan,3,34,142,251,19,12308,270,450
chan,3,35,143,250,18,12309,268,450
chan,3,36,144,249,17,12310,266,450
chan,3,37,148,245,11,12316,256,450
chan,3,38,148,245,11,12316,256,450
chan,3,39,149,244,10,12317,254,450
chan,3,40,149,244,10,12317,254,450
chan,3,41,149,244,10,12317,254,450
chan,3,42,147,246,12,12315,258,450
chan,3,43,148,245,11,12316,256,450
chan,3,44,150,243,9,12318,252,450
chan,3,45,152,241,7,12320,248,450
chan,3,46,149,244,10,12317,254,450
chan,3,47,150,243,9,12318,252,450
chan,3,48,148,245,11,12316,256,450
chan,3,49,150,243,9,12318,252,450
chan,3,50,152,241,7,12320,248,450
chan,4,1,59,334,29,12298,363,600
chan,4,2,93,300,37,12290,337,600
chan,4,3,115,278,60,12267,338,600
chan,4,4,122,271,66,12261,337,600
chan,4,5,121,272,65,12262,337,600
chan,4,6,123,270,52,12275,322,600
chan,4,7,119,274,61,12266,335,600
chan,4,8,125,268,53,12274,321,600
chan,4,9,124,269,52,12275,321,600
chan,4,10,127,266,49,12278,315,600
chan,4,11,127,266,51,12276,317,600
chan,4,12,129,264,44,12283,308,600
chan,4,13,134,259,33,12294,292,600
chan,4,14,132,261,35,12292,296,600
chan,4,15,129,264,40,12287,304,600
chan,4,16,130,263,38,12289,301,600
chan,4,17,132,261,34,12293,295,600
chan,4,18,132,261,32,12295,293,600
chan,4,19,133,260,28,12299,288,600
chan,4,20,134,259,29,12298,288,600
chan,4,21,133,260,27,12300,287,600
chan,4,22,139,254,22,12305,276,600
chan,4,23,143,250,19,12308,269,600
chan,4,24,141,252,22,12305,274,600
chan,4,25,145,248,18,12309,266,600
chan,4,26,146,247,14,12313,261,600
chan,4,27,147,246,13,12314,259,600
chan,4,28,142,251,18,12309,269,600
chan,4,29,144,249,16,12311,265,600
chan,4,30,146,247,14,12313,261,600
chan,4,31,146,247,16,12311,263,600
chan,4,32,146,247,16,12311,263,600
chan,4,33,150,243,10,12317,253,600
chan,4,34,151,242,9,12318,251,600
chan,4,35,152,241,7,12320,248,600
chan,4,36,153,240,6,12321,246,600
chan,4,37,154,239,5,12322,244,600
chan,4,38,154,239,5,12322,244,600
chan,4,39,154,239,5,12322,244,600
chan,4,40,152,241,7,12320,248,600
chan,4,41,151,242,8,12319,250,600
chan,4,42,152,241,7,12320,248,600
chan,4,43,153,240,6,12321,246,600
chan,4,44,153,240,6,12321,246,600
chan,4,45,153,240,6,12321,246,600
chan,4,46,154,239,5,12322,244,600
chan,4,47,154,239,5,12322,244,600
chan,4,48,154,239,5,12322,244,600
chan,4,49,154,239,5,12322,244,600
chan,4,50,154,239,5,12322,244,600
chan,5,1,62,331,25,12302,356,750
chan,5,2,103,290,47,12280,337,750
chan,5,3,117,276,55,12272,331,750
chan,5,4,131,262,58,12269,320,750
chan,5,5,142,251,67,12260,318,750
chan,5,6,137,256,59,12268,315,750
chan,5,7,132,261,54,12273,315,750
chan,5,8,134,259,47,12280,306,750
chan,5,9,129,264,48,12279,312,750
chan,5,10,133,260,38,12289,298,750
chan,5,11,132,261,35,12292,296,750
chan,5,12,132,261,37,12290,298,750
chan,5,13,136,257,30,12297,287,750
chan,5,14,137,256,30,12297,286,750
chan,5,15,139,254,24,12303,278,750
chan,5,16,140,253,24,12303,277,750
chan,5,17,142,251,20,12307,271,750
chan,5,18,141,252,20,12307,272,750
chan,5,19,142,251,21,12306,272,750
chan,5,20,143,250,20,12307,270,750
chan,5,21,143,250,21,12306,271,750
chan,5,22,142,251,21,12306,272,750
chan,5,23,140,253,22,12305,275,750
chan,5,24,140,253,22,12305,275,750
chan,5,25,144,249,16,12311,265,750
chan,5,26,145,248,15,12312,263,750
chan,5,27,146,247,13,12314,260,750
chan,5,28,147,246,12,12315,258,750
chan,5,29,148,245,12,12315,257,750
chan,5,30,146,247,14,12313,261,750
chan,5,31,147,246,13,12314,259,750
chan,5,32,147,246,12,12315,258,750
chan,5,33,146,247,13,12314,260,750
chan,5,34,147,246,12,12315,258,750
chan,5,35,148,245,12,12315,257,750
chan,5,36,149,244,11,12316,255,750
chan,5,37,150,243,10,12317,253,750
chan,5,38,151,242,9,12318,251,750
chan,5,39,150,243,10,12317,253,750
chan,5,40,151,242,9,12318,251,750
chan,5,41,150,243,9,12318,252,750
chan,5,42,150,243,9,12318,252,750
chan,5,43,150,243,9,12318,252,750
chan,5,44,150,243,9,12318,252,750
chan,5,45,150,243,9,12318,252,750
chan,5,46,150,243,9,12318,252,750
chan,5,47,151,242,8,12319,250,750
chan,5,48,151,242,8,12319,250,750
chan,5,49,151,242,8,12319,250,750
chan,5,50,152,241,7,12320,248,750
chan,6,1,62,331,30,12297,361,900
chan,6,2,94,299,53,12274,352,900
chan,6,3,107,286,72,12255,358,900
chan,6,4,113,280,76,12251,356,900
chan,6,5,117,276,72,12255,348,900
chan,6,6,124,269,76,12251,345,900
chan,6,7,127,266,73,12254,339,900
chan,6,8,125,268,64,12263,332,900
chan,6,9,129,264,45,12282,309,900
chan,6,10,129,264,44,12283,308,900
chan,6,11,131,262,38,12289,300,900
chan,6,12,129,264,40,12287,304,900
chan,6,13,129,264,40,12287,304,900
chan,6,14,125,268,42,12285,310,900
chan,6,15,129,264,36,12291,300,900
chan,6,16,132,261,31,12296,292,900
chan,6,17,132,261,31,12296,292,900
chan,6,18,136,257,27,12300,284,900
chan,6,19,134,259,29,12298,288,900
chan,6,20,134,259,29,12298,288,900
chan,6,21,134,259,29,12298,288,900
chan,6,22,138,255,25,12302,280,900
chan,6,23,139,254,24,12303,278,900
chan,6,24,140,253,24,12303,277,900
chan,6,25,141,252,22,12305,274,900
chan,6,26,140,253,23,12304,276,900
chan,6,27,142,251,21,12306,272,900
chan,6,28,145,248,17,12310,265,900
chan,6,29,145,248,17,12310,265,900
chan,6,30,145,248,15,12312,263,900
chan,6,31,145,248,15,12312,263,900
chan,6,32,145,248,16,12311,264,900
chan,6,33,147,246,14,12313,260,900
chan,6,34,147,246,14,12313,260,900
chan,6,35,148,245,13,12314,258,900
chan,6,36,147,246,14,12313,260,900
chan,6,37,149,244,12,12315,256,900
chan,6,38,150,243,11,12316,254,900
chan,6,39,151,242,10,12317,252,900
chan,6,40,152,241,8,12319,249,900
chan,6,41,152,241,8,12319,249,900
chan,6,42,152,241,8,12319,249,900
chan,6,43,151,242,8,12319,250,900
chan,6,44,152,241,8,12319,249,900
chan,6,45,151,242,8,12319,250,900
chan,6,46,151,242,8,12319,250,900
chan,6,47,149,244,10,12317,254,900
chan,6,48,150,243,9,12318,252,900
chan,6,49,150,243,9,12318,252,900
chan,6,50,151,242,8,12319,250,900
chan,7,1,53,340,31,12296,371,1050
chan,7,2,84,309,46,12281,355,1050
chan,7,3,111,282,67,12260,349,1050
chan,7,4,123,270,81,12246,351,1050
chan,7,5,122,271,78,12249,349,1050
chan,7,6,125,268,62,12265,330,1050
chan,7,7,125,268,61,12266,329,1050
chan,7,8,129,264,61,12266,325,1050
chan,7,9,126,267,59,12268,326,1050
chan,7,10,126,267,54,12273,321,1050
chan,7,11,129,264,43,12284,307,1050
chan,7,12,133,260,40,12287,300,1050
chan,7,13,134,259,36,12291,295,1050
chan,7,14,135,258,39,12288,297,1050
chan,7,15,134,259,39,12288,298,1050
chan,7,16,134,259,31,12296,290,1050
chan,7,17,132,261,33,12294,294,1050
chan,7,18,135,258,31,12296,289,1050
chan,7,19,138,255,27,12300,282,1050
chan,7,20,137,256,29,12298,285,1050
chan,7,21,141,252,25,12302,277,1050
chan,7,22,139,254,25,12302,279,1050
chan,7,23,139,254,26,12301,280,1050
chan,7,24,140,253,23,12304,276,1050
chan,7,25,143,250,20,12307,270,1050
chan,7,26,143,250,18,12309,268,1050
chan,7,27,143,250,19,12308,269,1050
chan,7,28,146,247,17,12310,264,1050
chan,7,29,147,246,15,12312,261,1050
chan,7,30,147,246,14,12313,260,1050
chan,7,31,149,244,12,12315,256,1050
chan,7,32,150,243,12,12315,255,1050
chan,7,33,148,245,13,12314,258,1050
chan,7,34,148,245,13,12314,258,1050
chan,7,35,147,246,14,12313,260,1050
chan,7,36,148,245,11,12316,256,1050
chan,7,37,149,244,11,12316,255,1050
chan,7,38,148,245,11,12316,256,1050
chan,7,39,149,244,10,12317,254,1050
chan,7,40,150,243,9,12318,252,1050
chan,7,41,151,242,8,12319,250,1050
chan,7,42,152,241,7,12320,248,1050
chan,7,43,152,241,7,12320,248,1050
chan,7,44,152,241,7,12320,248,1050
chan,7,45,153,240,6,12321,246,1050
chan,7,46,152,241,7,12320,248,1050
chan,7,47,154,239,5,12322,244,1050
chan,7,48,154,239,5,12322,244,1050
chan,7,49,155,238,4,12323,242,1050
chan,7,50,156,237,4,12323,241,1050
chan,8,1,60,333,34,12293,367,1200
chan,8,2,94,299,58,12269,357,1200
chan,8,3,116,277,75,12252,352,1200
chan,8,4,125,268,75,12252,343,1200
chan,8,5,132,261,69,12258,330,1200
chan,8,6,139,254,62,12265,316,1200
chan,8,7,133,260,62,12265,322,1200
chan,8,8,135,258,53,12274,311,1200
chan,8,9,139,254,48,12279,302,1200
chan,8,10,139,254,48,12279,302,1200
chan,8,11,145,248,32,12295,280,1200
chan,8,12,141,252,30,12297,282,1200
chan,8,13,143,250,28,12299,278,1200
chan,8,14,146,247,24,12303,271,1200
chan,8,15,144,249,19,12308,268,1200
chan,8,16,143,250,17,12310,267,1200
chan,8,17,143,250,17,12310,267,1200
chan,8,18,140,253,19,12308,272,1200
chan,8,19,138,255,22,12305,277,1200
chan,8,20,142,251,18,12309,269,1200
chan,8,21,143,250,18,12309,268,1200
chan,8,22,143,250,18,12309,268,1200
chan,8,23,144,249,16,12311,265,1200
chan,8,24,145,248,15,12312,263,1200
chan,8,25,144,249,15,12312,264,1200
chan,8,26,144,249,15,12312,264,1200
chan,8,27,147,246,13,12314,259,1200
chan,8,28,149,244,10,12317,254,1200
chan,8,29,149,244,10,12317,254,1200
chan,8,30,149,244,10,12317,254,1200
chan,8,31,149,244,10,12317,254,1200
chan,8,32,152,241,8,12319,249,1200
chan,8,33,151,242,8,12319,250,1200
chan,8,34,152,241,7,12320,248,1200
chan,8,35,150,243,9,12318,252,1200
chan,8,36,150,243,9,12318,252,1200
chan,8,37,150,243,9,12318,252,1200
chan,8,38,150,243,9,12318,252,1200
chan,8,39,150,243,9,12318,252,1200
chan,8,40,150,243,9,12318,252,1200
chan,8,41,150,243,9,12318,252,1200
chan,8,42,151,242,8,12319,250,1200
chan,8,43,151,242,8,12319,250,1200
chan,8,44,151,242,9,12318,251,1200
chan,8,45,149,244,10,12317,254,1200
chan,8,46,150,243,9,12318,252,1200
chan,8,47,152,241,8,12319,249,1200
chan,8,48,152,241,8,12319,249,1200
chan,8,49,152,241,8,12319,249,1200
chan,8,50,152,241,8,12319,249,1200
chan,9,1,54,339,30,12297,369,1350
chan,9,2,85,308,39,12288,347,1350
chan,9,3,109,284,50,12277,334,1350
chan,9,4,118,275,52,12275,327,1350
chan,9,5,124,269,51,12276,320,1350
chan,9,6,119,274,64,12263,338,1350
chan,9,7,120,273,54,12273,327,1350
chan,9,8,125,268,53,12274,321,1350
chan,9,9,119,274,57,12270,331,1350
chan,9,10,126,267,56,12271,323,1350
chan,9,11,128,265,45,12282,310,1350
chan,9,12,133,260,45,12282,305,1350
chan,9,13,132,261,41,12286,302,1350
chan,9,14,136,257,39,12288,296,1350
chan,9,15,141,252,34,12293,286,1350
chan,9,16,142,251,31,12296,282,1350
chan,9,17,148,245,14,12313,259,1350
chan,9,18,146,247,15,12312,262,1350
chan,9,19,143,250,18,12309,268,1350
chan,9,20,143,250,17,12310,267,1350
chan,9,21,143,250,16,12311,266,1350
chan,9,22,143,250,17,12310,267,1350
chan,9,23,144,249,15,12312,264,1350
chan,9,24,144,249,15,12312,264,1350
chan,9,25,144,249,15,12312,264,1350
chan,9,26,147,246,12,12315,258,1350
chan,9,27,147,246,12,12315,258,1350
chan,9,28,146,247,14,12313,261,1350
chan,9,29,148,245,11,12316,256,1350
chan,9,30,150,243,9,12318,252,1350
chan,9,31,149,244,10,12317,254,1350
chan,9,32,149,244,10,12317,254,1350
chan,9,33,149,244,10,12317,254,1350
chan,9,34,151,242,8,12319,250,1350
chan,9,35,154,239,5,12322,244,1350
chan,9,36,153,240,6,12321,246,1350
chan,9,37,153,240,6,12321,246,1350
chan,9,38,152,241,7,12320,248,1350
chan,9,39,152,241,7,12320,248,1350
chan,9,40,155,238,4,12323,242,1350
chan,9,41,155,238,4,12323,242,1350
chan,9,42,154,239,5,12322,244,1350
chan,9,43,153,240,6,12321,246,1350
chan,9,44,154,239,5,12322,244,1350
chan,9,45,154,239,5,12322,244,1350
chan,9,46,154,239,5,12322,244,1350
chan,9,47,155,238,4,12323,242,1350
chan,9,48,155,238,4,12323,242,1350
chan,9,49,155,238,4,12323,242,1350
chan,9,50,156,237,3,12324,240,1350
chan,10,1,58,335,30,12297,365,1500
chan,10,2,90,303,49,12278,352,1500
chan,10,3,121,272,54,12273,326,1500
chan,10,4,130,263,56,12271,319,1500
chan,10,5,132,261,51,12276,312,1500
chan,10,6,135,258,60,12267,318,1500
chan,10,7,144,249,50,12277,299,1500
chan,10,8,144,249,40,12287,289,1500
chan,10,9,143,250,35,12292,285,1500
chan,10,10,147,246,32,12295,278,1500
chan,10,11,145,248,35,12292,283,1500
chan,10,12,145,248,35,12292,283,1500
chan,10,13,147,246,32,12295,278,1500
chan,10,14,144,249,31,12296,280,1500
chan,10,15,154,239,20,12307,259,1500
chan,10,16,154,239,16,12311,255,1500
chan,10,17,145,248,18,12309,266,1500
chan,10,18,145,248,16,12311,264,1500
chan,10,19,143,250,19,12308,269,1500
chan,10,20,142,251,20,12307,271,1500
chan,10,21,140,253,21,12306,274,1500
chan,10,22,145,248,16,12311,264,1500
chan,10,23,149,244,12,12315,256,1500
chan,10,24,149,244,10,12317,254,1500
chan,10,25,147,246,12,12315,258,1500
chan,10,26,145,248,14,12313,262,1500
chan,10,27,146,247,13,12314,260,1500
chan,10,28,148,245,11,12316,256,1500
chan,10,29,149,244,10,12317,254,1500
chan,10,30,150,243,9,12318,252,1500
chan,10,31,148,245,11,12316,256,1500
chan,10,32,153,240,6,12321,246,1500
chan,10,33,152,241,7,12320,248,1500
chan,10,34,151,242,8,12319,250,1500
chan,10,35,151,242,8,12319,250,1500
chan,10,36,149,244,10,12317,254,1500
chan,10,37,151,242,9,12318,251,1500
chan,10,38,155,238,5,12322,243,1500
chan,10,39,153,240,7,12320,247,1500
chan,10,40,154,239,6,12321,245,1500
chan,10,41,154,239,6,12321,245,1500
chan,10,42,154,239,6,12321,245,1500
chan,10,43,154,239,6,12321,245,1500
chan,10,44,154,239,6,12321,245,1500
chan,10,45,153,240,6,12321,246,1500
chan,10,46,155,238,5,12322,243,1500
chan,10,47,155,238,4,12323,242,1500
chan,10,48,155,238,4,12323,242,1500
chan,10,49,154,239,5,12322,244,1500
chan,10,50,154,239,5,12322,244,1500
chan,11,1,59,334,31,12296,365,1650
chan,11,2,89,304,48,12279,352,1650
chan,11,3,109,284,66,12261,350,1650
chan,11,4,112,281,79,12248,360,1650
chan,11,5,119,274,86,12241,360,1650
chan,11,6,126,267,76,12251,343,1650
chan,11,7,128,265,73,12254,338,1650
chan,11,8,129,264,58,12269,322,1650
chan,11,9,121,272,52,12275,324,1650
chan,11,10,124,269,46,12281,315,1650
chan,11,11,123,270,47,12280,317,1650
chan,11,12,125,268,46,12281,314,1650
chan,11,13,137,256,35,12292,291,1650
chan,11,14,139,254,30,12297,284,1650
chan,11,15,138,255,28,12299,283,1650
chan,11,16,138,255,26,12301,281,1650
chan,11,17,140,253,26,12301,279,1650
chan,11,18,143,250,24,12303,274,1650
chan,11,19,142,251,21,12306,272,1650
chan,11,20,143,250,20,12307,270,1650
chan,11,21,144,249,17,12310,266,1650
chan,11,22,144,249,17,12310,266,1650
chan,11,23,146,247,16,12311,263,1650
chan,11,24,146,247,15,12312,262,1650
chan,11,25,146,247,15,12312,262,1650
chan,11,26,146,247,15,12312,262,1650
chan,11,27,146,247,14,12313,261,1650
chan,11,28,146,247,14,12313,261,1650
chan,11,29,147,246,13,12314,259,1650
chan,11,30,150,243,10,12317,253,1650
chan,11,31,150,243,9,12318,252,1650
chan,11,32,152,241,8,12319,249,1650
chan,11,33,152,241,7,12320,248,1650
chan,11,34,153,240,6,12321,246,1650
chan,11,35,152,241,7,12320,248,1650
chan,11,36,153,240,6,12321,246,1650
chan,11,37,154,239,5,12322,244,1650
chan,11,38,154,239,5,12322,244,1650
chan,11,39,153,240,6,12321,246,1650
chan,11,40,153,240,6,12321,246,1650
chan,11,41,153,240,6,12321,246,1650
chan,11,42,153,240,6,12321,246,1650
chan,11,43,154,239,5,12322,244,1650
chan,11,44,154,239,5,12322,244,1650
chan,11,45,154,239,5,12322,244,1650
chan,11,46,154,239,5,12322,244,1650
chan,11,47,154,239,5,12322,244,1650
chan,11,48,154,239,5,12322,244,1650
chan,11,49,154,239,6,12321,245,1650
chan,11,50,154,239,6,12321,245,1650
chan,12,1,50,343,30,12297,373,1800
chan,12,2,82,311,47,12280,358,1800
chan,12,3,91,302,67,12260,369,1800
chan,12,4,111,282,75,12252,357,1800
chan,12,5,119,274,62,12265,336,1800
chan,12,6,124,269,64,12263,333,1800
chan,12,7,127,266,68,12259,334,1800
chan,12,8,130,263,59,12268,322,1800
chan,12,9,125,268,60,12267,328,1800
chan,12,10,125,268,55,12272,323,1800
chan,12,11,131,262,47,12280,309,1800
chan,12,12,131,262,40,12287,302,1800
chan,12,13,132,261,40,12287,301,1800
chan,12,14,131,262,38,12289,300,1800
chan,12,15,131,262,37,12290,299,1800
chan,12,16,136,257,30,12297,287,1800
chan,12,17,138,255,28,12299,283,1800
chan,12,18,140,253,30,12297,283,1800
chan,12,19,141,252,29,12298,281,1800
chan,12,20,143,250,24,12303,274,1800
chan,12,21,142,251,24,12303,275,1800
chan,12,22,143,250,22,12305,272,1800
chan,12,23,142,251,22,12305,273,1800
chan,12,24,143,250,21,12306,271,1800
chan,12,25,143,250,21,12306,271,1800
chan,12,26,144,249,23,12304,272,1800
chan,12,27,147,246,19,12308,265,1800
chan,12,28,144,249,18,12309,267,1800
chan,12,29,146,247,18,12309,265,1800
chan,12,30,145,248,17,12310,265,1800
chan,12,31,146,247,18,12309,265,1800
chan,12,32,149,244,16,12311,260,1800
chan,12,33,148,245,16,12311,261,1800
chan,12,34,148,245,16,12311,261,1800
chan,12,35,146,247,18,12309,265,1800
chan,12,36,146,247,16,12311,263,1800
chan,12,37,146,247,16,12311,263,1800
chan,12,38,146,247,17,12310,264,1800
chan,12,39,147,246,16,12311,262,1800
chan,12,40,147,246,15,12312,261,1800
chan,12,41,147,246,15,12312,261,1800
chan,12,42,147,246,16,12311,262,1800
chan,12,43,146,247,17,12310,264,1800
chan,12,44,146,247,17,12310,264,1800
chan,12,45,147,246,15,12312,261,1800
chan,12,46,147,246,15,12312,261,1800
chan,12,47,148,245,15,12312,260,1800
chan,12,48,148,245,15,12312,260,1800
chan,12,49,147,246,16,12311,262,1800
chan,12,50,148,245,14,12313,259,1800
chan,13,1,62,331,28,12299,359,1950
chan,13,2,77,316,43,12284,359,1950
chan,13,3,100,293,59,12268,352,1950
chan,13,4,122,271,63,12264,334,1950
chan,13,5,107,286,67,12260,353,1950
chan,13,6,114,279,63,12264,342,1950
chan,13,7,125,268,62,12265,330,1950
chan,13,8,120,273,57,12270,330,1950
chan,13,9,124,269,49,12278,318,1950
chan,13,10,125,268,47,12280,315,1950
chan,13,11,128,265,40,12287,305,1950
chan,13,12,129,264,37,12290,301,1950
chan,13,13,134,259,31,12296,290,1950
chan,13,14,137,256,28,12299,284,1950
chan,13,15,140,253,24,12303,277,1950
chan,13,16,141,252,24,12303,276,1950
chan,13,17,139,254,25,12302,279,1950
chan,13,18,137,256,26,12301,282,1950
chan,13,19,135,258,28,12299,286,1950
chan,13,20,139,254,24,12303,278,1950
chan,13,21,137,256,26,12301,282,1950
chan,13,22,140,253,21,12306,274,1950
chan,13,23,140,253,22,12305,275,1950
chan,13,24,144,249,19,12308,268,1950
chan,13,25,144,249,19,12308,268,1950
chan,13,26,147,246,15,12312,261,1950
chan,13,27,146,247,16,12311,263,1950
chan,13,28,148,245,14,12313,259,1950
chan,13,29,148,245,13,12314,258,1950
chan,13,30,148,245,14,12313,259,1950
chan,13,31,148,245,14,12313,259,1950
chan,13,32,147,246,13,12314,259,1950
chan,13,33,147,246,14,12313,260,1950
chan,13,34,149,244,11,12316,255,1950
chan,13,35,150,243,9,12318,252,1950
chan,13,36,149,244,11,12316,255,1950
chan,13,37,149,244,11,12316,255,1950
chan,13,38,151,242,8,12319,250,1950
chan,13,39,153,240,6,12321,246,1950
chan,13,40,153,240,6,12321,246,1950
chan,13,41,154,239,5,12322,244,1950
chan,13,42,154,239,5,12322,244,1950
chan,13,43,154,239,5,12322,244,1950
chan,13,44,154,239,5,12322,244,1950
chan,13,45,154,239,5,12322,244,1950
chan,13,46,154,239,5,12322,244,1950
chan,13,47,154,239,5,12322,244,1950
chan,13,48,153,240,6,12321,246,1950
chan,13,49,153,240,6,12321,246,1950
chan,13,50,154,239,5,12322,244,1950
chan,14,1,60,333,22,12305,355,2100
chan,14,2,108,285,34,12293,319,2100
chan,14,3,117,276,55,12272,331,2100
chan,14,4,122,271,75,12252,346,2100
chan,14,5,128,265,75,12252,340,2100
chan,14,6,128,265,71,12256,336,2100
chan,14,7,133,260,60,12267,320,2100
chan,14,8,135,258,51,12276,309,2100
chan,14,9,131,262,55,12272,317,2100
chan,14,10,137,256,44,12283,300,2100
chan,14,11,135,258,39,12288,297,2100
chan,14,12,131,262,43,12284,305,2100
chan,14,13,134,259,39,12288,298,2100
chan,14,14,135,258,39,12288,297,2100
chan,14,15,136,257,33,12294,290,2100
chan,14,16,139,254,32,12295,286,2100
chan,14,17,140,253,27,12300,280,2100
chan,14,18,140,253,25,12302,278,2100
chan,14,19,141,252,24,12303,276,2100
chan,14,20,141,252,25,12302,277,2100
chan,14,21,141,252,25,12302,277,2100
chan,14,22,143,250,24,12303,274,2100
chan,14,23,145,248,21,12306,269,2100
chan,14,24,148,245,19,12308,264,2100
chan,14,25,146,247,19,12308,266,2100
chan,14,26,146,247,18,12309,265,2100
chan,14,27,148,245,17,12310,262,2100
chan,14,28,149,244,13,12314,257,2100
chan,14,29,149,244,14,12313,258,2100
chan,14,30,149,244,14,12313,258,2100
chan,14,31,149,244,13,12314,257,2100
chan,14,32,149,244,14,12313,258,2100
chan,14,33,150,243,12,12315,255,2100
chan,14,34,148,245,14,12313,259,2100
chan,14,35,149,244,14,12313,258,2100
chan,14,36,148,245,14,12313,259,2100
chan,14,37,149,244,13,12314,257,2100
chan,14,38,149,244,12,12315,256,2100
chan,14,39,150,243,11,12316,254,2100
chan,14,40,150,243,11,12316,254,2100
chan,14,41,150,243,11,12316,254,2100
chan,14,42,151,242,10,12317,252,2100
chan,14,43,152,241,9,12318,250,2100
chan,14,44,152,241,9,12318,250,2100
chan,14,45,152,241,9,12318,250,2100
chan,14,46,152,241,9,12318,250,2100
chan,14,47,151,242,10,12317,252,2100
chan,14,48,151,242,10,12317,252,2100
chan,14,49,151,242,10,12317,252,2100
chan,14,50,153,240,8,12319,248,2100
chan,15,1,44,349,33,12294,382,2250
chan,15,2,88,305,52,12275,357,2250
chan,15,3,109,284,58,12269,342,2250
chan,15,4,114,279,64,12263,343,2250
chan,15,5,117,276,70,12257,346,2250
chan,15,6,126,267,72,12255,339,2250
chan,15,7,129,264,68,12259,332,2250
chan,15,8,120,273,75,12252,348,2250
chan,15,9,122,271,67,12260,338,2250
chan,15,10,121,272,59,12268,331,2250
chan,15,11,124,269,48,12279,317,2250
chan,15,12,125,268,51,12276,319,2250
chan,15,13,123,270,51,12276,321,2250
chan,15,14,127,266,47,12280,313,2250
chan,15,15,133,260,35,12292,295,2250
chan,15,16,133,260,33,12294,293,2250
chan,15,17,133,260,34,12293,294,2250
chan,15,18,135,258,32,12295,290,2250
chan,15,19,136,257,28,12299,285,2250
chan,15,20,135,258,31,12296,289,2250
chan,15,21,135,258,29,12298,287,2250
chan,15,22,138,255,26,12301,281,2250
chan,15,23,139,254,25,12302,279,2250
chan,15,24,142,251,21,12306,272,2250
chan,15,25,142,251,20,12307,271,2250
chan,15,26,141,252,21,12306,273,2250
chan,15,27,140,253,20,12307,273,2250
chan,15,28,140,253,21,12306,274,2250
chan,15,29,141,252,20,12307,272,2250
chan,15,30,143,250,18,12309,268,2250
chan,15,31,147,246,16,12311,262,2250
chan,15,32,148,245,14,12313,259,2250
chan,15,33,150,243,12,12315,255,2250
chan,15,34,150,243,12,12315,255,2250
chan,15,35,150,243,12,12315,255,2250
chan,15,36,151,242,11,12316,253,2250
chan,15,37,152,241,10,12317,251,2250
chan,15,38,152,241,10,12317,251,2250
chan,15,39,151,242,11,12316,253,2250
chan,15,40,150,243,12,12315,255,2250
chan,15,41,149,244,10,12317,254,2250
chan,15,42,151,242,8,12319,250,2250
chan,15,43,151,242,8,12319,250,2250
chan,15,44,151,242,8,12319,250,2250
chan,15,45,151,242,8,12319,250,2250
chan,15,46,151,242,8,12319,250,2250
chan,15,47,152,241,7,12320,248,2250
chan,15,48,153,240,6,12321,246,2250
chan,15,49,154,239,5,12322,244,2250
chan,15,50,154,239,5,12322,244,2250
chan,16,1,60,333,25,12302,358,2400
chan,16,2,90,303,49,12278,352,2400
chan,16,3,108,285,66,12261,351,2400
chan,16,4,121,272,67,12260,339,2400
chan,16,5,122,271,74,12253,345,2400
chan,16,6,119,274,74,12253,348,2400
chan,16,7,119,274,77,12250,351,2400
chan,16,8,125,268,69,12258,337,2400
chan,16,9,125,268,61,12266,329,2400
chan,16,10,121,272,59,12268,331,2400
chan,16,11,127,266,51,12276,317,2400
chan,16,12,127,266,50,12277,316,2400
chan,16,13,128,265,46,12281,311,2400
chan,16,14,126,267,44,12283,311,2400
chan,16,15,130,263,41,12286,304,2400
chan,16,16,133,260,34,12293,294,2400
chan,16,17,137,256,28,12299,284,2400
chan,16,18,136,257,28,12299,285,2400
chan,16,19,140,253,21,12306,274,2400
chan,16,20,139,254,22,12305,276,2400
chan,16,21,139,254,20,12307,274,2400
chan,16,22,144,249,16,12311,265,2400
chan,16,23,143,250,18,12309,268,2400
chan,16,24,146,247,15,12312,262,2400
chan,16,25,145,248,16,12311,264,2400
chan,16,26,147,246,13,12314,259,2400
chan,16,27,146,247,15,12312,262,2400
chan,16,28,149,244,10,12317,254,2400
chan,16,29,149,244,10,12317,254,2400
chan,16,30,148,245,11,12316,256,2400
chan,16,31,149,244,10,12317,254,2400
chan,16,32,148,245,11,12316,256,2400
chan,16,33,147,246,12,12315,258,2400
chan,16,34,149,244,10,12317,254,2400
chan,16,35,149,244,10,12317,254,2400
chan,16,36,150,243,10,12317,253,2400
chan,16,37,151,242,8,12319,250,2400
chan,16,38,151,242,8,12319,250,2400
chan,16,39,152,241,8,12319,249,2400
chan,16,40,152,241,7,12320,248,2400
chan,16,41,152,241,7,12320,248,2400
chan,16,42,153,240,6,12321,246,2400
chan,16,43,152,241,7,12320,248,2400
chan,16,44,151,242,8,12319,250,2400
chan,16,45,151,242,8,12319,250,2400
chan,16,46,151,242,8,12319,250,2400
chan,16,47,153,240,6,12321,246,2400
chan,16,48,153,240,6,12321,246,2400
chan,16,49,154,239,6,12321,245,2400
chan,16,50,154,239,6,12321,245,2400
chan,17,1,57,336,34,12293,370,2550
chan,17,2,92,301,47,12280,348,2550
chan,17,3,109,284,56,12271,340,2550
chan,17,4,130,263,59,12268,322,2550
chan,17,5,134,259,63,12264,322,2550
chan,17,6,135,258,55,12272,313,2550
chan,17,7,135,258,57,12270,315,2550
chan,17,8,136,257,50,12277,307,2550
chan,17,9,136,257,52,12275,309,2550
chan,17,10,138,255,41,12286,296,2550
chan,17,11,136,257,38,12289,295,2550
chan,17,12,136,257,36,12291,293,2550
chan,17,13,141,252,34,12293,286,2550
chan,17,14,137,256,31,12296,287,2550
chan,17,15,137,256,31,12296,287,2550
chan,17,16,136,257,29,12298,286,2550
chan,17,17,140,253,27,12300,280,2550
chan,17,18,142,251,24,12303,275,2550
chan,17,19,142,251,22,12305,273,2550
chan,17,20,144,249,24,12303,273,2550
chan,17,21,146,247,20,12307,267,2550
chan,17,22,146,247,16,12311,263,2550
chan,17,23,145,248,18,12309,266,2550
chan,17,24,148,245,15,12312,260,2550
chan,17,25,146,247,17,12310,264,2550
chan,17,26,146,247,16,12311,263,2550
chan,17,27,145,248,16,12311,264,2550
chan,17,28,147,246,14,12313,260,2550
chan,17,29,147,246,13,12314,259,2550
chan,17,30,148,245,13,12314,258,2550
chan,17,31,150,243,11,12316,254,2550
chan,17,32,149,244,11,12316,255,2550
chan,17,33,149,244,12,12315,256,2550
chan,17,34,150,243,11,12316,254,2550
chan,17,35,149,244,11,12316,255,2550
chan,17,36,149,244,12,12315,256,2550
chan,17,37,150,243,11,12316,254,2550
chan,17,38,151,242,9,12318,251,2550
chan,17,39,152,241,8,12319,249,2550
chan,17,40,152,241,8,12319,249,2550
chan,17,41,152,241,8,12319,249,2550
chan,17,42,152,241,8,12319,249,2550
chan,17,43,153,240,7,12320,247,2550
chan,17,44,154,239,7,12320,246,2550
chan,17,45,155,238,4,12323,242,2550
chan,17,46,155,238,4,12323,242,2550
chan,17,47,155,238,4,12323,242,2550
chan,17,48,155,238,4,12323,242,2550
chan,17,49,154,239,5,12322,244,2550
chan,17,50,153,240,6,12321,246,2550
chan,18,1,64,329,21,12306,350,2700
chan,18,2,102,291,41,12286,332,2700
chan,18,3,118,275,60,12267,335,2700
chan,18,4,122,271,75,12252,346,2700
chan,18,5,121,272,69,12258,341,2700
chan,18,6,124,269,65,12262,334,2700
chan,18,7,122,271,57,12270,328,2700
chan,18,8,130,263,55,12272,318,2700
chan,18,9,132,261,53,12274,314,2700
chan,18,10,132,261,51,12276,312,2700
chan,18,11,131,262,38,12289,300,2700
chan,18,12,132,261,42,12285,303,2700
chan,18,13,136,257,33,12294,290,2700
chan,18,14,137,256,31,12296,287,2700
chan,18,15,140,253,25,12302,278,2700
chan,18,16,136,257,27,12300,284,2700
chan,18,17,139,254,25,12302,279,2700
chan,18,18,142,251,25,12302,276,2700
chan,18,19,138,255,27,12300,282,2700
chan,18,20,137,256,29,12298,285,2700
chan,18,21,136,257,30,12297,287,2700
chan,18,22,144,249,21,12306,270,2700
chan,18,23,144,249,23,12304,272,2700
chan,18,24,144,249,22,12305,271,2700
chan,18,25,144,249,20,12307,269,2700
chan,18,26,142,251,22,12305,273,2700
chan,18,27,143,250,17,12310,267,2700
chan,18,28,145,248,18,12309,266,2700
chan,18,29,142,251,21,12306,272,2700
chan,18,30,145,248,18,12309,266,2700
chan,18,31,145,248,15,12312,263,2700
chan,18,32,146,247,14,12313,261,2700
chan,18,33,146,247,14,12313,261,2700
chan,18,34,147,246,13,12314,259,2700
chan,18,35,148,245,12,12315,257,2700
chan,18,36,147,246,13,12314,259,2700
chan,18,37,147,246,13,12314,259,2700
chan,18,38,147,246,14,12313,260,2700
chan,18,39,146,247,15,12312,262,2700
chan,18,40,146,247,15,12312,262,2700
chan,18,41,147,246,14,12313,260,2700
chan,18,42,147,246,14,12313,260,2700
chan,18,43,147,246,14,12313,260,2700
chan,18,44,149,244,12,12315,256,2700
chan,18,45,147,246,14,12313,260,2700
chan,18,46,148,245,13,12314,258,2700
chan,18,47,147,246,14,12313,260,2700
chan,18,48,148,245,13,12314,258,2700
chan,18,49,149,244,12,12315,256,2700
chan,18,50,149,244,12,12315,256,2700
chan,19,1,55,338,35,12292,373,2850
chan,19,2,82,311,49,12278,360,2850
chan,19,3,102,291,70,12257,361,2850
chan,19,4,110,283,74,12253,357,2850
chan,19,5,118,275,73,12254,348,2850
chan,19,6,112,281,81,12246,362,2850
chan,19,7,115,278,70,12257,348,2850
chan,19,8,118,275,66,12261,341,2850
chan,19,9,120,273,62,12265,335,2850
chan,19,10,121,272,59,12268,331,2850
chan,19,11,121,272,55,12272,327,2850
chan,19,12,128,265,42,12285,307,2850
chan,19,13,128,265,44,12283,309,2850
chan,19,14,129,264,35,12292,299,2850
chan,19,15,131,262,32,12295,294,2850
chan,19,16,136,257,27,12300,284,2850
chan,19,17,135,258,26,12301,284,2850
chan,19,18,136,257,25,12302,282,2850
chan,19,19,142,251,17,12310,268,2850
chan,19,20,143,250,16,12311,266,2850
chan,19,21,144,249,15,12312,264,2850
chan,19,22,145,248,15,12312,263,2850
chan,19,23,147,246,14,12313,260,2850
chan,19,24,144,249,15,12312,264,2850
chan,19,25,144,249,15,12312,264,2850
chan,19,26,143,250,16,12311,266,2850
chan,19,27,143,250,16,12311,266,2850
chan,19,28,143,250,16,12311,266,2850
chan,19,29,145,248,15,12312,263,2850
chan,19,30,146,247,13,12314,260,2850
chan,19,31,148,245,11,12316,256,2850
chan,19,32,145,248,14,12313,262,2850
chan,19,33,145,248,14,12313,262,2850
chan,19,34,148,245,11,12316,256,2850
chan,19,35,148,245,11,12316,256,2850
chan,19,36,148,245,11,12316,256,2850
chan,19,37,149,244,10,12317,254,2850
chan,19,38,151,242,8,12319,250,2850
chan,19,39,152,241,7,12320,248,2850
chan,19,40,152,241,7,12320,248,2850
chan,19,41,152,241,8,12319,249,2850
chan,19,42,151,242,8,12319,250,2850
chan,19,43,153,240,6,12321,246,2850
chan,19,44,156,237,4,12323,241,2850
chan,19,45,154,239,5,12322,244,2850
chan,19,46,155,238,4,12323,242,2850
chan,19,47,155,238,4,12323,242,2850
chan,19,48,155,238,4,12323,242,2850
chan,19,49,155,238,5,12322,243,2850
chan,19,50,154,239,5,12322,244,2850
chan,20,1,51,342,28,12299,370,3000
chan,20,2,83,310,47,12280,357,3000
chan,20,3,93,300,60,12267,360,3000
chan,20,4,101,292,80,12247,372,3000
chan,20,5,111,282,86,12241,368,3000
chan,20,6,124,269,69,12258,338,3000
chan,20,7,124,269,69,12258,338,3000
chan,20,8,120,273,68,12259,341,3000
chan,20,9,123,270,57,12270,327,3000
chan,20,10,120,273,59,12268,332,3000
chan,20,11,122,271,54,12273,325,3000
chan,20,12,124,269,52,12275,321,3000
chan,20,13,124,269,49,12278,318,3000
chan,20,14,126,267,43,12284,310,3000
chan,20,15,130,263,44,12283,307,3000
chan,20,16,134,259,38,12289,297,3000
chan,20,17,137,256,41,12286,297,3000
chan,20,18,136,257,40,12287,297,3000
chan,20,19,138,255,38,12289,293,3000
chan,20,20,139,254,34,12293,288,3000
chan,20,21,141,252,29,12298,281,3000
chan,20,22,142,251,26,12301,277,3000
chan,20,23,142,251,25,12302,276,3000
chan,20,24,141,252,26,12301,278,3000
chan,20,25,144,249,23,12304,272,3000
chan,20,26,143,250,23,12304,273,3000
chan,20,27,144,249,21,12306,270,3000
chan,20,28,145,248,20,12307,268,3000
chan,20,29,147,246,18,12309,264,3000
chan,20,30,147,246,16,12311,262,3000
chan,20,31,145,248,19,12308,267,3000
chan,20,32,146,247,18,12309,265,3000
chan,20,33,149,244,11,12316,255,3000
chan,20,34,150,243,10,12317,253,3000
chan,20,35,151,242,9,12318,251,3000
chan,20,36,151,242,8,12319,250,3000
chan,20,37,149,244,10,12317,254,3000
chan,20,38,151,242,8,12319,250,3000
chan,20,39,152,241,7,12320,248,3000
chan,20,40,153,240,6,12321,246,3000
chan,20,41,155,238,4,12323,242,3000
chan,20,42,154,239,5,12322,244,3000
chan,20,43,154,239,5,12322,244,3000
chan,20,44,153,240,7,12320,247,3000
chan,20,45,154,239,6,12321,245,3000
chan,20,46,155,238,4,12323,242,3000
chan,20,47,155,238,4,12323,242,3000
chan,20,48,156,237,3,12324,240,3000
chan,20,49,156,237,3,12324,240,3000
chan,20,50,156,237,3,12324,240,3000
chan,21,1,51,342,34,12293,376,3150
chan,21,2,89,304,54,12273,358,3150
chan,21,3,101,292,60,12267,352,3150
chan,21,4,111,282,64,12263,346,3150
chan,21,5,117,276,72,12255,348,3150
chan,21,6,122,271,68,12259,339,3150
chan,21,7,128,265,56,12271,321,3150
chan,21,8,124,269,55,12272,324,3150
chan,21,9,128,265,39,12288,304,3150
chan,21,10,130,263,39,12288,302,3150
chan,21,11,134,259,39,12288,298,3150
chan,21,12,131,262,36,12291,298,3150
chan,21,13,135,258,31,12296,289,3150
chan,21,14,137,256,28,12299,284,3150
chan,21,15,136,257,30,12297,287,3150
chan,21,16,135,258,31,12296,289,3150
chan,21,17,132,261,34,12293,295,3150
chan,21,18,135,258,31,12296,289,3150
chan,21,19,135,258,30,12297,288,3150
chan,21,20,140,253,26,12301,279,3150
chan,21,21,144,249,21,12306,270,3150
chan,21,22,144,249,21,12306,270,3150
chan,21,23,144,249,22,12305,271,3150
chan,21,24,144,249,22,12305,271,3150
chan,21,25,145,248,19,12308,267,3150
chan,21,26,145,248,19,12308,267,3150
chan,21,27,146,247,19,12308,266,3150
chan,21,28,147,246,16,12311,262,3150
chan,21,29,148,245,14,12313,259,3150
chan,21,30,147,246,15,12312,261,3150
chan,21,31,148,245,14,12313,259,3150
chan,21,32,150,243,10,12317,253,3150
chan,21,33,151,242,10,12317,252,3150
chan,21,34,152,241,9,12318,250,3150
chan,21,35,152,241,7,12320,248,3150
chan,21,36,151,242,10,12317,252,3150
chan,21,37,151,242,8,12319,250,3150
chan,21,38,153,240,7,12320,247,3150
chan,21,39,153,240,7,12320,247,3150
chan,21,40,153,240,6,12321,246,3150
chan,21,41,153,240,6,12321,246,3150
chan,21,42,153,240,6,12321,246,3150
chan,21,43,152,241,7,12320,248,3150
chan,21,44,153,240,6,12321,246,3150
chan,21,45,152,241,7,12320,248,3150
chan,21,46,152,241,7,12320,248,3150
chan,21,47,153,240,6,12321,246,3150
chan,21,48,153,240,6,12321,246,3150
chan,21,49,152,241,7,12320,248,3150
chan,21,50,153,240,6,12321,246,3150
chan,22,1,54,339,34,12293,373,3300
chan,22,2,80,313,55,12272,368,3300
chan,22,3,94,299,57,12270,356,3300
chan,22,4,103,290,58,12269,348,3300
chan,22,5,106,287,54,12273,341,3300
chan,22,6,116,277,52,12275,329,3300
chan,22,7,115,278,57,12270,335,3300
chan,22,8,120,273,55,12272,328,3300
chan,22,9,131,262,45,12282,307,3300
chan,22,10,128,265,46,12281,311,3300
chan,22,11,134,259,44,12283,303,3300
chan,22,12,136,257,44,12283,301,3300
chan,22,13,136,257,44,12283,301,3300
chan,22,14,134,259,35,12292,294,3300
chan,22,15,135,258,32,12295,290,3300
chan,22,16,137,256,31,12296,287,3300
chan,22,17,139,254,26,12301,280,3300
chan,22,18,138,255,26,12301,281,3300
chan,22,19,138,255,25,12302,280,3300
chan,22,20,141,252,21,12306,273,3300
chan,22,21,142,251,20,12307,271,3300
chan,22,22,142,251,20,12307,271,3300
chan,22,23,141,252,19,12308,271,3300
chan,22,24,142,251,18,12309,269,3300
chan,22,25,144,249,16,12311,265,3300
chan,22,26,143,250,17,12310,267,3300
chan,22,27,145,248,15,12312,263,3300
chan,22,28,146,247,14,12313,261,3300
chan,22,29,147,246,13,12314,259,3300
chan,22,30,147,246,13,12314,259,3300
chan,22,31,146,247,14,12313,261,3300
chan,22,32,145,248,16,12311,264,3300
chan,22,33,147,246,14,12313,260,3300
chan,22,34,147,246,14,12313,260,3300
chan,22,35,147,246,13,12314,259,3300
chan,22,36,146,247,14,12313,261,3300
chan,22,37,146,247,14,12313,261,3300
chan,22,38,147,246,13,12314,259,3300
chan,22,39,147,246,13,12314,259,3300
chan,22,40,147,246,13,12314,259,3300
chan,22,41,147,246,13,12314,259,3300
chan,22,42,147,246,13,12314,259,3300
chan,22,43,147,246,13,12314,259,3300
chan,22,44,148,245,12,12315,257,3300
chan,22,45,149,244,12,12315,256,3300
chan,22,46,150,243,11,12316,254,3300
chan,22,47,150,243,10,12317,253,3300
chan,22,48,150,243,10,12317,253,3300
chan,22,49,151,242,9,12318,251,3300
chan,22,50,152,241,8,12319,249,3300
chan,23,1,60,333,28,12299,361,3450
chan,23,2,89,304,53,12274,357,3450
chan,23,3,104,289,67,12260,356,3450
chan,23,4,110,283,70,12257,353,3450
chan,23,5,112,281,65,12262,346,3450
chan,23,6,123,270,69,12258,339,3450
chan,23,7,127,266,57,12270,323,3450
chan,23,8,124,269,52,12275,321,3450
chan,23,9,125,268,42,12285,310,3450
chan,23,10,130,263,42,12285,305,3450
chan,23,11,133,260,40,12287,300,3450
chan,23,12,137,256,38,12289,294,3450
chan,23,13,138,255,33,12294,288,3450
chan,23,14,137,256,36,12291,292,3450
chan,23,15,137,256,30,12297,286,3450
chan,23,16,140,253,28,12299,281,3450
chan,23,17,141,252,27,12300,279,3450
chan,23,18,143,250,26,12301,276,3450
chan,23,19,145,248,22,12305,270,3450
chan,23,20,146,247,20,12307,267,3450
chan,23,21,146,247,20,12307,267,3450
chan,23,22,146,247,15,12312,262,3450
chan,23,23,148,245,14,12313,259,3450
chan,23,24,149,244,13,12314,257,3450
chan,23,25,151,242,11,12316,253,3450
chan,23,26,150,243,12,12315,255,3450
chan,23,27,150,243,10,12317,253,3450
chan,23,28,151,242,9,12318,251,3450
chan,23,29,149,244,13,12314,257,3450
chan,23,30,150,243,9,12318,252,3450
chan,23,31,151,242,9,12318,251,3450
chan,23,32,151,242,9,12318,251,3450
chan,23,33,151,242,9,12318,251,3450
chan,23,34,151,242,9,12318,251,3450
chan,23,35,149,244,10,12317,254,3450
chan,23,36,151,242,8,12319,250,3450
chan,23,37,151,242,8,12319,250,3450
chan,23,38,151,242,8,12319,250,3450
chan,23,39,151,242,8,12319,250,3450
chan,23,40,151,242,8,12319,250,3450
chan,23,41,153,240,6,12321,246,3450
chan,23,42,154,239,5,12322,244,3450
chan,23,43,154,239,5,12322,244,3450
chan,23,44,154,239,5,12322,244,3450
chan,23,45,154,239,5,12322,244,3450
chan,23,46,155,238,4,12323,242,3450
chan,23,47,155,238,4,12323,242,3450
chan,23,48,155,238,4,12323,242,3450
chan,23,49,155,238,5,12322,243,3450
chan,23,50,155,238,5,12322,243,3450
chan,24,1,65,328,25,12302,353,3600
chan,24,2,104,289,47,12280,336,3600
chan,24,3,113,280,57,12270,337,3600
chan,24,4,119,274,59,12268,333,3600
chan,24,5,130,263,63,12264,326,3600
chan,24,6,133,260,63,12264,323,3600
chan,24,7,136,257,61,12266,318,3600
chan,24,8,132,261,57,12270,318,3600
chan,24,9,126,267,52,12275,319,3600
chan,24,10,127,266,47,12280,313,3600
chan,24,11,127,266,46,12281,312,3600
chan,24,12,129,264,40,12287,304,3600
chan,24,13,131,262,36,12291,298,3600
chan,24,14,129,264,39,12288,303,3600
chan,24,15,133,260,33,12294,293,3600
chan,24,16,133,260,31,12296,291,3600
chan,24,17,133,260,32,12295,292,3600
chan,24,18,139,254,26,12301,280,3600
chan,24,19,141,252,18,12309,270,3600
chan,24,20,143,250,20,12307,270,3600
chan,24,21,145,248,16,12311,264,3600
chan,24,22,146,247,15,12312,262,3600
chan,24,23,149,244,15,12312,259,3600
chan,24,24,147,246,16,12311,262,3600
chan,24,25,145,248,16,12311,264,3600
chan,24,26,144,249,15,12312,264,3600
chan,24,27,147,246,14,12313,260,3600
chan,24,28,148,245,13,12314,258,3600
chan,24,29,146,247,13,12314,260,3600
chan,24,30,148,245,13,12314,258,3600
chan,24,31,148,245,11,12316,256,3600
chan,24,32,147,246,12,12315,258,3600
chan,24,33,148,245,11,12316,256,3600
chan,24,34,149,244,10,12317,254,3600
chan,24,35,150,243,9,12318,252,3600
chan,24,36,152,241,8,12319,249,3600
chan,24,37,153,240,7,12320,247,3600
chan,24,38,153,240,7,12320,247,3600
chan,24,39,152,241,8,12319,249,3600
chan,24,40,153,240,7,12320,247,3600
chan,24,41,155,238,5,12322,243,3600
chan,24,42,154,239,6,12321,245,3600
chan,24,43,154,239,6,12321,245,3600
chan,24,44,153,240,7,12320,247,3600
chan,24,45,153,240,7,12320,247,3600
chan,24,46,153,240,7,12320,247,3600
chan,24,47,153,240,7,12320,247,3600
chan,24,48,153,240,7,12320,247,3600
chan,24,49,153,240,7,12320,247,3600
chan,24,50,153,240,6,12321,246,3600
chan,25,1,69,324,24,12303,348,3750
chan,25,2,107,286,30,12297,316,3750
chan,25,3,117,276,41,12286,317,3750
chan,25,4,125,268,56,12271,324,3750
chan,25,5,124,269,56,12271,325,3750
chan,25,6,128,265,57,12270,322,3750
chan,25,7,128,265,53,12274,318,3750
chan,25,8,130,263,51,12276,314,3750
chan,25,9,133,260,53,12274,313,3750
chan,25,10,127,266,53,12274,319,3750
chan,25,11,130,263,47,12280,310,3750
chan,25,12,132,261,43,12284,304,3750
chan,25,13,131,262,44,12283,306,3750
chan,25,14,132,261,48,12279,309,3750
chan,25,15,134,259,46,12281,305,3750
chan,25,16,131,262,44,12283,306,3750
chan,25,17,134,259,42,12285,301,3750
chan,25,18,138,255,35,12292,290,3750
chan,25,19,141,252,32,12295,284,3750
chan,25,20,141,252,28,12299,280,3750
chan,25,21,140,253,28,12299,281,3750
chan,25,22,141,252,24,12303,276,3750
chan,25,23,143,250,23,12304,273,3750
chan,25,24,143,250,24,12303,274,3750
chan,25,25,141,252,22,12305,274,3750
chan,25,26,143,250,21,12306,271,3750
chan,25,27,142,251,21,12306,272,3750
chan,25,28,143,250,21,12306,271,3750
chan,25,29,143,250,17,12310,267,3750
chan,25,30,141,252,19,12308,271,3750
chan,25,31,140,253,19,12308,272,3750
chan,25,32,140,253,20,12307,273,3750
chan,25,33,140,253,19,12308,272,3750
chan,25,34,140,253,19,12308,272,3750
chan,25,35,143,250,17,12310,267,3750
chan,25,36,144,249,15,12312,264,3750
chan,25,37,145,248,14,12313,262,3750
chan,25,38,147,246,12,12315,258,3750
chan,25,39,148,245,11,12316,256,3750
chan,25,40,149,244,11,12316,255,3750
chan,25,41,151,242,9,12318,251,3750
chan,25,42,153,240,7,12320,247,3750
chan,25,43,152,241,7,12320,248,3750
chan,25,44,152,241,7,12320,248,3750
chan,25,45,152,241,7,12320,248,3750
chan,25,46,152,241,7,12320,248,3750
chan,25,47,152,241,7,12320,248,3750
chan,25,48,152,241,7,12320,248,3750
chan,25,49,152,241,7,12320,248,3750
chan,25,50,153,240,6,12321,246,3750
chan,26,1,55,338,34,12293,372,3900
chan,26,2,84,309,45,12282,354,3900
chan,26,3,102,291,57,12270,348,3900
chan,26,4,107,286,66,12261,352,3900
chan,26,5,117,276,74,12253,350,3900
chan,26,6,123,270,79,12248,349,3900
chan,26,7,122,271,78,12249,349,3900
chan,26,8,122,271,63,12264,334,3900
chan,26,9,124,269,59,12268,328,3900
chan,26,10,131,262,51,12276,313,3900
chan,26,11,131,262,51,12276,313,3900
chan,26,12,131,262,50,12277,312,3900
chan,26,13,131,262,46,12281,308,3900
chan,26,14,132,261,36,12291,297,3900
chan,26,15,133,260,39,12288,299,3900
chan,26,16,141,252,34,12293,286,3900
chan,26,17,137,256,33,12294,289,3900
chan,26,18,137,256,33,12294,289,3900
chan,26,19,141,252,31,12296,283,3900
chan,26,20,144,249,26,12301,275,3900
chan,26,21,142,251,26,12301,277,3900
chan,26,22,141,252,25,12302,277,3900
chan,26,23,143,250,24,12303,274,3900
chan,26,24,144,249,23,12304,272,3900
chan,26,25,147,246,20,12307,266,3900
chan,26,26,148,245,12,12315,257,3900
chan,26,27,149,244,16,12311,260,3900
chan,26,28,146,247,13,12314,260,3900
chan,26,29,148,245,11,12316,256,3900
chan,26,30,150,243,9,12318,252,3900
chan,26,31,150,243,9,12318,252,3900
chan,26,32,150,243,9,12318,252,3900
chan,26,33,151,242,8,12319,250,3900
chan,26,34,150,243,9,12318,252,3900
chan,26,35,152,241,7,12320,248,3900
chan,26,36,152,241,7,12320,248,3900
chan,26,37,152,241,8,12319,249,3900
chan,26,38,151,242,8,12319,250,3900
chan,26,39,151,242,8,12319,250,3900
chan,26,40,151,242,8,12319,250,3900
chan,26,41,151,242,8,12319,250,3900
chan,26,42,151,242,8,12319,250,3900
chan,26,43,152,241,7,12320,248,3900
chan,26,44,152,241,7,12320,248,3900
chan,26,45,153,240,6,12321,246,3900
chan,26,46,152,241,7,12320,248,3900
chan,26,47,152,241,7,12320,248,3900
chan,26,48,152,241,7,12320,248,3900
chan,26,49,153,240,6,12321,246,3900
chan,26,50,153,240,6,12321,246,3900
chan,27,1,53,340,27,12300,367,4050
chan,27,2,73,320,55,12272,375,4050
chan,27,3,100,293,66,12261,359,4050
chan,27,4,113,280,76,12251,356,4050
chan,27,5,116,277,85,12242,362,4050
chan,27,6,119,274,79,12248,353,4050
chan,27,7,123,270,76,12251,346,4050
chan,27,8,124,269,65,12262,334,4050
chan,27,9,130,263,57,12270,320,4050
chan,27,10,128,265,48,12279,313,4050
chan,27,11,124,269,45,12282,314,4050
chan,27,12,125,268,43,12284,311,4050
chan,27,13,129,264,35,12292,299,4050
chan,27,14,126,267,38,12289,305,4050
chan,27,15,126,267,38,12289,305,4050
chan,27,16,127,266,36,12291,302,4050
chan,27,17,133,260,33,12294,293,4050
chan,27,18,139,254,27,12300,281,4050
chan,27,19,140,253,27,12300,280,4050
chan,27,20,139,254,27,12300,281,4050
chan,27,21,140,253,25,12302,278,4050
chan,27,22,141,252,24,12303,276,4050
chan,27,23,143,250,20,12307,270,4050
chan,27,24,142,251,20,12307,271,4050
chan,27,25,141,252,21,12306,273,4050
chan,27,26,142,251,18,12309,269,4050
chan,27,27,144,249,16,12311,265,4050
chan,27,28,144,249,16,12311,265,4050
chan,27,29,146,247,14,12313,261,4050
chan,27,30,143,250,17,12310,267,4050
chan,27,31,141,252,18,12309,270,4050
chan,27,32,141,252,18,12309,270,4050
chan,27,33,142,251,17,12310,268,4050
chan,27,34,145,248,14,12313,262,4050
chan,27,35,146,247,13,12314,260,4050
chan,27,36,147,246,12,12315,258,4050
chan,27,37,146,247,13,12314,260,4050
chan,27,38,147,246,12,12315,258,4050
chan,27,39,146,247,13,12314,260,4050
chan,27,40,146,247,13,12314,260,4050
chan,27,41,148,245,11,12316,256,4050
chan,27,42,148,245,11,12316,256,4050
chan,27,43,148,245,11,12316,256,4050
chan,27,44,147,246,12,12315,258,4050
chan,27,45,146,247,13,12314,260,4050
chan,27,46,148,245,11,12316,256,4050
chan,27,47,149,244,10,12317,254,4050
chan,27,48,149,244,10,12317,254,4050
chan,27,49,150,243,9,12318,252,4050
chan,27,50,147,246,12,12315,258,4050
chan,28,1,66,327,27,12300,354,4200
chan,28,2,91,302,30,12297,332,4200
chan,28,3,102,291,48,12279,339,4200
chan,28,4,115,278,44,12283,322,4200
chan,28,5,123,270,54,12273,324,4200
chan,28,6,129,264,58,12269,322,4200
chan,28,7,131,262,49,12278,311,4200
chan,28,8,137,256,52,12275,308,4200
chan,28,9,131,262,54,12273,316,4200
chan,28,10,138,255,51,12276,306,4200
chan,28,11,135,258,50,12277,308,4200
chan,28,12,138,255,50,12277,305,4200
chan,28,13,134,259,46,12281,305,4200
chan,28,14,129,264,43,12284,307,4200
chan,28,15,128,265,41,12286,306,4200
chan,28,16,130,263,35,12292,298,4200
chan,28,17,134,259,33,12294,292,4200
chan,28,18,138,255,29,12298,284,4200
chan,28,19,139,254,26,12301,280,4200
chan,28,20,140,253,24,12303,277,4200
chan,28,21,140,253,22,12305,275,4200
chan,28,22,141,252,22,12305,274,4200
chan,28,23,142,251,21,12306,272,4200
chan,28,24,141,252,21,12306,273,4200
chan,28,25,142,251,18,12309,269,4200
chan,28,26,144,249,16,12311,265,4200
chan,28,27,145,248,15,12312,263,4200
chan,28,28,148,245,12,12315,257,4200
chan,28,29,148,245,12,12315,257,4200
chan,28,30,150,243,11,12316,254,4200
chan,28,31,150,243,11,12316,254,4200
chan,28,32,153,240,9,12318,249,4200
chan,28,33,151,242,10,12317,252,4200
chan,28,34,151,242,10,12317,252,4200
chan,28,35,152,241,9,12318,250,4200
chan,28,36,152,241,9,12318,250,4200
chan,28,37,153,240,7,12320,247,4200
chan,28,38,154,239,6,12321,245,4200
chan,28,39,154,239,6,12321,245,4200
chan,28,40,153,240,7,12320,247,4200
chan,28,41,153,240,7,12320,247,4200
chan,28,42,152,241,8,12319,249,4200
chan,28,43,150,243,10,12317,253,4200
chan,28,44,151,242,9,12318,251,4200
chan,28,45,151,242,9,12318,251,4200
chan,28,46,151,242,9,12318,251,4200
chan,28,47,152,241,9,12318,250,4200
chan,28,48,151,242,9,12318,251,4200
chan,28,49,151,242,9,12318,251,4200
chan,28,50,151,242,9,12318,251,4200
chan,29,1,78,315,16,12311,331,4350
chan,29,2,92,301,41,12286,342,4350
chan,29,3,111,282,55,12272,337,4350
chan,29,4,111,282,53,12274,335,4350
chan,29,5,112,281,57,12270,338,4350
chan,29,6,123,270,61,12266,331,4350
chan,29,7,127,266,49,12278,315,4350
chan,29,8,134,259,45,12282,304,4350
chan,29,9,134,259,44,12283,303,4350
chan,29,10,136,257,43,12284,300,4350
chan,29,11,139,254,37,12290,291,4350
chan,29,12,143,250,26,12301,276,4350
chan,29,13,137,256,30,12297,286,4350
chan,29,14,140,253,27,12300,280,4350
chan,29,15,141,252,26,12301,278,4350
chan,29,16,141,252,27,12300,279,4350
chan,29,17,142,251,24,12303,275,4350
chan,29,18,138,255,25,12302,280,4350
chan,29,19,139,254,21,12306,275,4350
chan,29,20,140,253,20,12307,273,4350
chan,29,21,143,250,19,12308,269,4350
chan,29,22,145,248,14,12313,262,4350
chan,29,23,146,247,13,12314,260,4350
chan,29,24,146,247,14,12313,261,4350
chan,29,25,148,245,12,12315,257,4350
chan,29,26,148,245,12,12315,257,4350
chan,29,27,149,244,12,12315,256,4350
chan,29,28,149,244,12,12315,256,4350
chan,29,29,150,243,10,12317,253,4350
chan,29,30,151,242,9,12318,251,4350
chan,29,31,152,241,9,12318,250,4350
chan,29,32,150,243,9,12318,252,4350
chan,29,33,150,243,9,12318,252,4350
chan,29,34,151,242,8,12319,250,4350
chan,29,35,151,242,8,12319,250,4350
chan,29,36,151,242,8,12319,250,4350
chan,29,37,151,242,8,12319,250,4350
chan,29,38,151,242,8,12319,250,4350
chan,29,39,151,242,8,12319,250,4350
chan,29,40,149,244,10,12317,254,4350
chan,29,41,151,242,8,12319,250,4350
chan,29,42,152,241,7,12320,248,4350
chan,29,43,152,241,7,12320,248,4350
chan,29,44,153,240,6,12321,246,4350
chan,29,45,153,240,6,12321,246,4350
chan,29,46,153,240,6,12321,246,4350
chan,29,47,154,239,5,12322,244,4350
chan,29,48,153,240,6,12321,246,4350
chan,29,49,153,240,6,12321,246,4350
chan,29,50,152,241,7,12320,248,4350
chan,30,1,64,329,27,12300,356,4500
chan,30,2,80,313,56,12271,369,4500
chan,30,3,95,298,62,12265,360,4500
chan,30,4,106,287,70,12257,357,4500
chan,30,5,114,279,69,12258,348,4500
chan,30,6,122,271,69,12258,340,4500
chan,30,7,120,273,75,12252,348,4500
chan,30,8,119,274,62,12265,336,4500
chan,30,9,125,268,55,12272,323,4500
chan,30,10,129,264,47,12280,311,4500
chan,30,11,131,262,45,12282,307,4500
chan,30,12,132,261,43,12284,304,4500
chan,30,13,133,260,40,12287,300,4500
chan,30,14,134,259,35,12292,294,4500
chan,30,15,134,259,33,12294,292,4500
chan,30,16,137,256,29,12298,285,4500
chan,30,17,140,253,27,12300,280,4500
chan,30,18,144,249,24,12303,273,4500
chan,30,19,143,250,23,12304,273,4500
chan,30,20,142,251,20,12307,271,4500
chan,30,21,140,253,19,12308,272,4500
chan,30,22,139,254,20,12307,274,4500
chan,30,23,146,247,13,12314,260,4500
chan,30,24,144,249,15,12312,264,4500
chan,30,25,146,247,13,12314,260,4500
chan,30,26,146,247,14,12313,261,4500
chan,30,27,147,246,12,12315,258,4500
chan,30,28,146,247,13,12314,260,4500
chan,30,29,148,245,11,12316,256,4500
chan,30,30,147,246,12,12315,258,4500
chan,30,31,146,247,13,12314,260,4500
chan,30,32,146,247,13,12314,260,4500
chan,30,33,148,245,11,12316,256,4500
chan,30,34,149,244,13,12314,257,4500
chan,30,35,148,245,14,12313,259,4500
chan,30,36,147,246,15,12312,261,4500
chan,30,37,146,247,13,12314,260,4500
chan,30,38,146,247,13,12314,260,4500
chan,30,39,146,247,13,12314,260,4500
chan,30,40,149,244,10,12317,254,4500
chan,30,41,149,244,10,12317,254,4500
chan,30,42,148,245,11,12316,256,4500
chan,30,43,148,245,11,12316,256,4500
chan,30,44,148,245,11,12316,256,4500
chan,30,45,150,243,9,12318,252,4500
chan,30,46,151,242,8,12319,250,4500
chan,30,47,151,242,8,12319,250,4500
chan,30,48,151,242,8,12319,250,4500
chan,30,49,150,243,9,12318,252,4500
chan,30,50,150,243,9,12318,252,4500
chan,31,1,57,336,40,12287,376,4650
chan,31,2,90,303,51,12276,354,4650
chan,31,3,100,293,62,12265,355,4650
chan,31,4,101,292,72,12255,364,4650
chan,31,5,111,282,69,12258,351,4650
chan,31,6,120,273,69,12258,342,4650
chan,31,7,124,269,59,12268,328,4650
chan,31,8,121,272,55,12272,327,4650
chan,31,9,125,268,56,12271,324,4650
chan,31,10,126,267,52,12275,319,4650
chan,31,11,128,265,45,12282,310,4650
chan,31,12,127,266,43,12284,309,4650
chan,31,13,129,264,44,12283,308,4650
chan,31,14,130,263,40,12287,303,4650
chan,31,15,133,260,36,12291,296,4650
chan,31,16,134,259,33,12294,292,4650
chan,31,17,131,262,37,12290,299,4650
chan,31,18,134,259,34,12293,293,4650
chan,31,19,134,259,32,12295,291,4650
chan,31,20,136,257,30,12297,287,4650
chan,31,21,135,258,28,12299,286,4650
chan,31,22,133,260,27,12300,287,4650
chan,31,23,136,257,28,12299,285,4650
chan,31,24,141,252,19,12308,271,4650
chan,31,25,143,250,17,12310,267,4650
chan,31,26,143,250,17,12310,267,4650
chan,31,27,146,247,16,12311,263,4650
chan,31,28,144,249,16,12311,265,4650
chan,31,29,146,247,16,12311,263,4650
chan,31,30,146,247,14,12313,261,4650
chan,31,31,147,246,13,12314,259,4650
chan,31,32,149,244,12,12315,256,4650
chan,31,33,148,245,12,12315,257,4650
chan,31,34,148,245,12,12315,257,4650
chan,31,35,149,244,11,12316,255,4650
chan,31,36,151,242,10,12317,252,4650
chan,31,37,151,242,10,12317,252,4650
chan,31,38,152,241,9,12318,250,4650
chan,31,39,153,240,9,12318,249,4650
chan,31,40,152,241,9,12318,250,4650
chan,31,41,151,242,8,12319,250,4650
chan,31,42,151,242,9,12318,251,4650
chan,31,43,151,242,8,12319,250,4650
chan,31,44,148,245,11,12316,256,4650
chan,31,45,150,243,9,12318,252,4650
chan,31,46,148,245,11,12316,256,4650
chan,31,47,149,244,11,12316,255,4650
chan,31,48,146,247,13,12314,260,4650
chan,31,49,145,248,14,12313,262,4650
chan,31,50,145,248,14,12313,262,4650
chan,32,1,63,330,31,12296,361,4800
chan,32,2,99,294,33,12294,327,4800
chan,32,3,119,274,51,12276,325,4800
chan,32,4,118,275,60,12267,335,4800
chan,32,5,129,264,67,12260,331,4800
chan,32,6,127,266,61,12266,327,4800
chan,32,7,127,266,58,12269,324,4800
chan,32,8,127,266,58,12269,324,4800
chan,32,9,133,260,53,12274,313,4800
chan,32,10,130,263,51,12276,314,4800
chan,32,11,131,262,39,12288,301,4800
chan,32,12,139,254,34,12293,288,4800
chan,32,13,140,253,33,12294,286,4800
chan,32,14,140,253,35,12292,288,4800
chan,32,15,141,252,31,12296,283,4800
chan,32,16,142,251,31,12296,282,4800
chan,32,17,140,253,29,12298,282,4800
chan,32,18,140,253,28,12299,281,4800
chan,32,19,140,253,26,12301,279,4800
chan,32,20,140,253,27,12300,280,4800
chan,32,21,144,249,20,12307,269,4800
chan,32,22,144,249,20,12307,269,4800
chan,32,23,145,248,20,12307,268,4800
chan,32,24,149,244,17,12310,261,4800
chan,32,25,146,247,18,12309,265,4800
chan,32,26,148,245,17,12310,262,4800
chan,32,27,148,245,15,12312,260,4800
chan,32,28,151,242,12,12315,254,4800
chan,32,29,152,241,8,12319,249,4800
chan,32,30,152,241,13,12314,254,4800
chan,32,31,153,240,12,12315,252,4800
chan,32,32,155,238,4,12323,242,4800
chan,32,33,154,239,5,12322,244,4800
chan,32,34,154,239,5,12322,244,4800
chan,32,35,154,239,5,12322,244,4800
chan,32,36,153,240,6,12321,246,4800
chan,32,37,152,241,7,12320,248,4800
chan,32,38,152,241,7,12320,248,4800
chan,32,39,153,240,6,12321,246,4800
chan,32,40,153,240,7,12320,247,4800
chan,32,41,153,240,7,12320,247,4800
chan,32,42,153,240,7,12320,247,4800
chan,32,43,153,240,7,12320,247,4800
chan,32,44,152,241,8,12319,249,4800
chan,32,45,152,241,8,12319,249,4800
chan,32,46,152,241,8,12319,249,4800
chan,32,47,154,239,6,12321,245,4800
chan,32,48,155,238,5,12322,243,4800
chan,32,49,155,238,5,12322,243,4800
chan,32,50,156,237,5,12322,242,4800
chan,33,1,68,325,20,12307,345,4950
chan,33,2,98,295,36,12291,331,4950
chan,33,3,111,282,47,12280,329,4950
chan,33,4,114,279,58,12269,337,4950
chan,33,5,115,278,61,12266,339,4950
chan,33,6,125,268,58,12269,326,4950
chan,33,7,130,263,55,12272,318,4950
chan,33,8,128,265,52,12275,317,4950
chan,33,9,129,264,50,12277,314,4950
chan,33,10,130,263,47,12280,310,4950
chan,33,11,128,265,47,12280,312,4950
chan,33,12,133,260,45,12282,305,4950
chan,33,13,134,259,38,12289,297,4950
chan,33,14,138,255,34,12293,289,4950
chan,33,15,139,254,31,12296,285,4950
chan,33,16,138,255,35,12292,290,4950
chan,33,17,139,254,30,12297,284,4950
chan,33,18,139,254,31,12296,285,4950
chan,33,19,137,256,32,12295,288,4950
chan,33,20,138,255,32,12295,287,4950
chan,33,21,143,250,23,12304,273,4950
chan,33,22,143,250,17,12310,267,4950
chan,33,23,145,248,19,12308,267,4950
chan,33,24,143,250,20,12307,270,4950
chan,33,25,146,247,13,12314,260,4950
chan,33,26,146,247,13,12314,260,4950
chan,33,27,147,246,12,12315,258,4950
chan,33,28,147,246,12,12315,258,4950
chan,33,29,147,246,12,12315,258,4950
chan,33,30,147,246,12,12315,258,4950
chan,33,31,148,245,11,12316,256,4950
chan,33,32,148,245,11,12316,256,4950
chan,33,33,147,246,12,12315,258,4950
chan,33,34,149,244,10,12317,254,4950
chan,33,35,149,244,10,12317,254,4950
chan,33,36,149,244,10,12317,254,4950
chan,33,37,149,244,10,12317,254,4950
chan,33,38,149,244,10,12317,254,4950
chan,33,39,149,244,10,12317,254,4950
chan,33,40,149,244,10,12317,254,4950
chan,33,41,151,242,8,12319,250,4950
chan,33,42,151,242,9,12318,251,4950
chan,33,43,149,244,10,12317,254,4950
chan,33,44,151,242,8,12319,250,4950
chan,33,45,151,242,8,12319,250,4950
chan,33,46,152,241,8,12319,249,4950
chan,33,47,150,243,9,12318,252,4950
chan,33,48,152,241,7,12320,248,4950
chan,33,49,153,240,6,12321,246,4950
chan,33,50,153,240,6,12321,246,4950
chan,34,1,53,340,35,12292,375,5100
chan,34,2,82,311,55,12272,366,5100
chan,34,3,100,293,73,12254,366,5100
chan,34,4,105,288,70,12257,358,5100
chan,34,5,110,283,66,12261,349,5100
chan,34,6,115,278,75,12252,353,5100
chan,34,7,119,274,70,12257,344,5100
chan,34,8,124,269,56,12271,325,5100
chan,34,9,128,265,54,12273,319,5100
chan,34,10,125,268,49,12278,317,5100
chan,34,11,130,263,43,12284,306,5100
chan,34,12,129,264,39,12288,303,5100
chan,34,13,131,262,32,12295,294,5100
chan,34,14,134,259,29,12298,288,5100
chan,34,15,137,256,27,12300,283,5100
chan,34,16,134,259,29,12298,288,5100
chan,34,17,139,254,25,12302,279,5100
chan,34,18,139,254,23,12304,277,5100
chan,34,19,141,252,21,12306,273,5100
chan,34,20,142,251,20,12307,271,5100
chan,34,21,143,250,19,12308,269,5100
chan,34,22,146,247,16,12311,263,5100
chan,34,23,147,246,16,12311,262,5100
chan,34,24,145,248,16,12311,264,5100
chan,34,25,147,246,15,12312,261,5100
chan,34,26,148,245,13,12314,258,5100
chan,34,27,151,242,10,12317,252,5100
chan,34,28,151,242,10,12317,252,5100
chan,34,29,151,242,12,12315,254,5100
chan,34,30,153,240,9,12318,249,5100
chan,34,31,153,240,10,12317,250,5100
chan,34,32,154,239,8,12319,247,5100
chan,34,33,154,239,8,12319,247,5100
chan,34,34,152,241,9,12318,250,5100
chan,34,35,152,241,8,12319,249,5100
chan,34,36,152,241,8,12319,249,5100
chan,34,37,151,242,9,12318,251,5100
chan,34,38,152,241,8,12319,249,5100
chan,34,39,153,240,7,12320,247,5100
chan,34,40,154,239,6,12321,245,5100
chan,34,41,154,239,6,12321,245,5100
chan,34,42,154,239,6,12321,245,5100
chan,34,43,154,239,6,12321,245,5100
chan,34,44,156,237,3,12324,240,5100
chan,34,45,157,236,2,12325,238,5100
chan,34,46,157,236,2,12325,238,5100
chan,34,47,157,236,2,12325,238,5100
chan,34,48,158,235,1,12326,236,5100
chan,34,49,157,236,2,12325,238,5100
chan,34,50,157,236,2,12325,238,5100
chan,35,1,64,329,33,12294,362,5250
chan,35,2,100,293,57,12270,350,5250
chan,35,3,112,281,63,12264,344,5250
chan,35,4,127,266,62,12265,328,5250
chan,35,5,140,253,58,12269,311,5250
chan,35,6,135,258,55,12272,313,5250
chan,35,7,132,261,49,12278,310,5250
chan,35,8,130,263,45,12282,308,5250
chan,35,9,124,269,46,12281,315,5250
chan,35,10,133,260,45,12282,305,5250
chan,35,11,128,265,37,12290,302,5250
chan,35,12,131,262,37,12290,299,5250
chan,35,13,134,259,33,12294,292,5250
chan,35,14,135,258,33,12294,291,5250
chan,35,15,138,255,29,12298,284,5250
chan,35,16,138,255,24,12303,279,5250
chan,35,17,144,249,22,12305,271,5250
chan,35,18,143,250,23,12304,273,5250
chan,35,19,144,249,19,12308,268,5250
chan,35,20,144,249,21,12306,270,5250
chan,35,21,149,244,14,12313,258,5250
chan,35,22,149,244,15,12312,259,5250
chan,35,23,149,244,15,12312,259,5250
chan,35,24,148,245,16,12311,261,5250
chan,35,25,148,245,15,12312,260,5250
chan,35,26,148,245,15,12312,260,5250
chan,35,27,145,248,15,12312,263,5250
chan,35,28,146,247,14,12313,261,5250
chan,35,29,146,247,14,12313,261,5250
chan,35,30,147,246,15,12312,261,5250
chan,35,31,146,247,14,12313,261,5250
chan,35,32,148,245,11,12316,256,5250
chan,35,33,148,245,11,12316,256,5250
chan,35,34,149,244,11,12316,255,5250
chan,35,35,150,243,10,12317,253,5250
chan,35,36,151,242,9,12318,251,5250
chan,35,37,148,245,11,12316,256,5250
chan,35,38,150,243,9,12318,252,5250
chan,35,39,151,242,8,12319,250,5250
chan,35,40,151,242,8,12319,250,5250
chan,35,41,151,242,8,12319,250,5250
chan,35,42,151,242,8,12319,250,5250
chan,35,43,151,242,8,12319,250,5250
chan,35,44,151,242,8,12319,250,5250
chan,35,45,152,241,7,12320,248,5250
chan,35,46,152,241,7,12320,248,5250
chan,35,47,154,239,5,12322,244,5250
chan,35,48,154,239,5,12322,244,5250
chan,35,49,154,239,5,12322,244,5250
chan,35,50,154,239,5,12322,244,5250
chan,36,1,49,344,38,12289,382,5400
chan,36,2,91,302,60,12267,362,5400
chan,36,3,98,295,68,12259,363,5400
chan,36,4,104,289,70,12257,359,5400
chan,36,5,111,282,71,12256,353,5400
chan,36,6,121,272,62,12265,334,5400
chan,36,7,121,272,53,12274,325,5400
chan,36,8,125,268,54,12273,322,5400
chan,36,9,130,263,49,12278,312,5400
chan,36,10,128,265,52,12275,317,5400
chan,36,11,125,268,49,12278,317,5400
chan,36,12,125,268,49,12278,317,5400
chan,36,13,127,266,43,12284,309,5400
chan,36,14,128,265,44,12283,309,5400
chan,36,15,136,257,36,12291,293,5400
chan,36,16,137,256,34,12293,290,5400
chan,36,17,136,257,35,12292,292,5400
chan,36,18,141,252,29,12298,281,5400
chan,36,19,138,255,29,12298,284,5400
chan,36,20,143,250,23,12304,273,5400
chan,36,21,143,250,21,12306,271,5400
chan,36,22,144,249,21,12306,270,5400
chan,36,23,144,249,19,12308,268,5400
chan,36,24,145,248,18,12309,266,5400
chan,36,25,145,248,17,12310,265,5400
chan,36,26,145,248,15,12312,263,5400
chan,36,27,147,246,13,12314,259,5400
chan,36,28,147,246,12,12315,258,5400
chan,36,29,147,246,12,12315,258,5400
chan,36,30,147,246,12,12315,258,5400
chan,36,31,147,246,12,12315,258,5400
chan,36,32,148,245,13,12314,258,5400
chan,36,33,148,245,13,12314,258,5400
chan,36,34,149,244,13,12314,257,5400
chan,36,35,148,245,14,12313,259,5400
chan,36,36,148,245,14,12313,259,5400
chan,36,37,148,245,13,12314,258,5400
chan,36,38,149,244,12,12315,256,5400
chan,36,39,150,243,11,12316,254,5400
chan,36,40,151,242,10,12317,252,5400
chan,36,41,151,242,10,12317,252,5400
chan,36,42,152,241,9,12318,250,5400
chan,36,43,152,241,9,12318,250,5400
chan,36,44,153,240,8,12319,248,5400
chan,36,45,153,240,6,12321,246,5400
chan,36,46,154,239,5,12322,244,5400
chan,36,47,153,240,6,12321,246,5400
chan,36,48,152,241,7,12320,248,5400
chan,36,49,152,241,7,12320,248,5400
chan,36,50,152,241,7,12320,248,5400
chan,37,1,52,341,29,12298,370,5550
chan,37,2,86,307,36,12291,343,5550
chan,37,3,101,292,53,12274,345,5550
chan,37,4,110,283,65,12262,348,5550
chan,37,5,118,275,61,12266,336,5550
chan,37,6,118,275,58,12269,333,5550
chan,37,7,124,269,51,12276,320,5550
chan,37,8,130,263,44,12283,307,5550
chan,37,9,132,261,43,12284,304,5550
chan,37,10,137,256,36,12291,292,5550
chan,37,11,135,258,35,12292,293,5550
chan,37,12,136,257,30,12297,287,5550
chan,37,13,138,255,31,12296,286,5550
chan,37,14,137,256,29,12298,285,5550
chan,37,15,139,254,23,12304,277,5550
chan,37,16,142,251,19,12308,270,5550
chan,37,17,142,251,19,12308,270,5550
chan,37,18,141,252,19,12308,271,5550
chan,37,19,142,251,18,12309,269,5550
chan,37,20,146,247,16,12311,263,5550
chan,37,21,145,248,14,12313,262,5550
chan,37,22,147,246,14,12313,260,5550
chan,37,23,145,248,16,12311,264,5550
chan,37,24,147,246,16,12311,262,5550
chan,37,25,146,247,14,12313,261,5550
chan,37,26,148,245,14,12313,259,5550
chan,37,27,148,245,12,12315,257,5550
chan,37,28,150,243,10,12317,253,5550
chan,37,29,151,242,10,12317,252,5550
chan,37,30,150,243,10,12317,253,5550
chan,37,31,150,243,10,12317,253,5550
chan,37,32,149,244,11,12316,255,5550
chan,37,33,149,244,11,12316,255,5550
chan,37,34,151,242,9,12318,251,5550
chan,37,35,151,242,9,12318,251,5550
chan,37,36,153,240,7,12320,247,5550
chan,37,37,153,240,6,12321,246,5550
chan,37,38,153,240,6,12321,246,5550
chan,37,39,153,240,7,12320,247,5550
chan,37,40,153,240,7,12320,247,5550
chan,37,41,153,240,7,12320,247,5550
chan,37,42,152,241,8,12319,249,5550
chan,37,43,151,242,9,12318,251,5550
chan,37,44,152,241,8,12319,249,5550
chan,37,45,151,242,9,12318,251,5550
chan,37,46,152,241,8,12319,249,5550
chan,37,47,152,241,8,12319,249,5550
chan,37,48,152,241,8,12319,249,5550
chan,37,49,153,240,7,12320,247,5550
chan,37,50,153,240,7,12320,247,5550
chan,38,1,59,334,27,12300,361,5700
chan,38,2,99,294,50,12277,344,5700
chan,38,3,117,276,62,12265,338,5700
chan,38,4,128,265,68,12259,333,5700
chan,38,5,130,263,68,12259,331,5700
chan,38,6,136,257,59,12268,316,5700
chan,38,7,135,258,52,12275,310,5700
chan,38,8,138,255,48,12279,303,5700
chan,38,9,139,254,54,12273,308,5700
chan,38,10,137,256,44,12283,300,5700
chan,38,11,142,251,40,12287,291,5700
chan,38,12,137,256,41,12286,297,5700
chan,38,13,138,255,34,12293,289,5700
chan,38,14,134,259,32,12295,291,5700
chan,38,15,135,258,29,12298,287,5700
chan,38,16,140,253,23,12304,276,5700
chan,38,17,143,250,25,12302,275,5700
chan,38,18,144,249,23,12304,272,5700
chan,38,19,141,252,24,12303,276,5700
chan,38,20,138,255,23,12304,278,5700
chan,38,21,140,253,20,12307,273,5700
chan,38,22,140,253,20,12307,273,5700
chan,38,23,139,254,21,12306,275,5700
chan,38,24,139,254,21,12306,275,5700
chan,38,25,140,253,20,12307,273,5700
chan,38,26,143,250,17,12310,267,5700
chan,38,27,147,246,13,12314,259,5700
chan,38,28,146,247,14,12313,261,5700
chan,38,29,147,246,13,12314,259,5700
chan,38,30,146,247,14,12313,261,5700
chan,38,31,146,247,14,12313,261,5700
chan,38,32,146,247,14,12313,261,5700
chan,38,33,147,246,14,12313,260,5700
chan,38,34,148,245,12,12315,257,5700
chan,38,35,148,245,12,12315,257,5700
chan,38,36,147,246,13,12314,259,5700
chan,38,37,147,246,13,12314,259,5700
chan,38,38,147,246,13,12314,259,5700
chan,38,39,147,246,13,12314,259,5700
chan,38,40,147,246,13,12314,259,5700
chan,38,41,149,244,11,12316,255,5700
chan,38,42,149,244,11,12316,255,5700
chan,38,43,151,242,10,12317,252,5700
chan,38,44,151,242,10,12317,252,5700
chan,38,45,152,241,8,12319,249,5700
chan,38,46,152,241,8,12319,249,5700
chan,38,47,154,239,5,12322,244,5700
chan,38,48,154,239,5,12322,244,5700
chan,38,49,155,238,4,12323,242,5700
chan,38,50,155,238,4,12323,242,5700
chan,39,1,54,339,23,12304,362,5850
chan,39,2,84,309,49,12278,358,5850
chan,39,3,107,286,67,12260,353,5850
chan,39,4,114,279,57,12270,336,5850
chan,39,5,125,268,63,12264,331,5850
chan,39,6,125,268,68,12259,336,5850
chan,39,7,125,268,66,12261,334,5850
chan,39,8,124,269,57,12270,326,5850
chan,39,9,120,273,60,12267,333,5850
chan,39,10,125,268,59,12268,327,5850
chan,39,11,125,268,49,12278,317,5850
chan,39,12,130,263,40,12287,303,5850
chan,39,13,137,256,35,12292,291,5850
chan,39,14,138,255,33,12294,288,5850
chan,39,15,139,254,28,12299,282,5850
chan,39,16,139,254,25,12302,279,5850
chan,39,17,143,250,26,12301,276,5850
chan,39,18,141,252,27,12300,279,5850
chan,39,19,143,250,25,12302,275,5850
chan,39,20,143,250,27,12300,277,5850
chan,39,21,142,251,23,12304,274,5850
chan,39,22,142,251,22,12305,273,5850
chan,39,23,138,255,29,12298,284,5850
chan,39,24,141,252,25,12302,277,5850
chan,39,25,142,251,24,12303,275,5850
chan,39,26,143,250,20,12307,270,5850
chan,39,27,145,248,20,12307,268,5850
chan,39,28,146,247,20,12307,267,5850
chan,39,29,145,248,20,12307,268,5850
chan,39,30,148,245,19,12308,264,5850
chan,39,31,146,247,14,12313,261,5850
chan,39,32,147,246,14,12313,260,5850
chan,39,33,148,245,13,12314,258,5850
chan,39,34,148,245,13,12314,258,5850
chan,39,35,148,245,12,12315,257,5850
chan,39,36,147,246,13,12314,259,5850
chan,39,37,147,246,13,12314,259,5850
chan,39,38,147,246,13,12314,259,5850
chan,39,39,149,244,11,12316,255,5850
chan,39,40,149,244,11,12316,255,5850
chan,39,41,149,244,11,12316,255,5850
chan,39,42,151,242,9,12318,251,5850
chan,39,43,153,240,7,12320,247,5850
chan,39,44,153,240,7,12320,247,5850
chan,39,45,153,240,7,12320,247,5850
chan,39,46,153,240,6,12321,246,5850
chan,39,47,153,240,6,12321,246,5850
chan,39,48,153,240,6,12321,246,5850
chan,39,49,152,241,7,12320,248,5850
chan,39,50,153,240,6,12321,246,5850
chan,40,1,60,333,31,12296,364,6000
chan,40,2,88,305,52,12275,357,6000
chan,40,3,108,285,63,12264,348,6000
chan,40,4,114,279,67,12260,346,6000
chan,40,5,114,279,70,12257,349,6000
chan,40,6,125,268,63,12264,331,6000
chan,40,7,121,272,57,12270,329,6000
chan,40,8,129,264,51,12276,315,6000
chan,40,9,126,267,54,12273,321,6000
chan,40,10,128,265,49,12278,314,6000
chan,40,11,128,265,45,12282,310,6000
chan,40,12,128,265,39,12288,304,6000
chan,40,13,134,259,34,12293,293,6000
chan,40,14,135,258,31,12296,289,6000
chan,40,15,138,255,28,12299,283,6000
chan,40,16,138,255,28,12299,283,6000
chan,40,17,143,250,24,12303,274,6000
chan,40,18,142,251,24,12303,275,6000
chan,40,19,141,252,21,12306,273,6000
chan,40,20,141,252,25,12302,277,6000
chan,40,21,143,250,20,12307,270,6000
chan,40,22,145,248,18,12309,266,6000
chan,40,23,142,251,23,12304,274,6000
chan,40,24,146,247,18,12309,265,6000
chan,40,25,145,248,15,12312,263,6000
chan,40,26,145,248,15,12312,263,6000
chan,40,27,143,250,18,12309,268,6000
chan,40,28,145,248,16,12311,264,6000
chan,40,29,146,247,15,12312,262,6000
chan,40,30,146,247,15,12312,262,6000
chan,40,31,147,246,16,12311,262,6000
chan,40,32,146,247,16,12311,263,6000
chan,40,33,145,248,17,12310,265,6000
chan,40,34,146,247,17,12310,264,6000
chan,40,35,145,248,17,12310,265,6000
chan,40,36,147,246,15,12312,261,6000
chan,40,37,148,245,12,12315,257,6000
chan,40,38,148,245,12,12315,257,6000
chan,40,39,148,245,11,12316,256,6000
chan,40,40,150,243,9,12318,252,6000
chan,40,41,152,241,7,12320,248,6000
chan,40,42,152,241,7,12320,248,6000
chan,40,43,153,240,6,12321,246,6000
chan,40,44,152,241,7,12320,248,6000
chan,40,45,153,240,6,12321,246,6000
chan,40,46,153,240,6,12321,246,6000
chan,40,47,153,240,6,12321,246,6000
chan,40,48,154,239,5,12322,244,6000
chan,40,49,154,239,5,12322,244,6000
chan,40,50,154,239,5,12322,244,6000
chan,41,1,49,344,33,12294,377,6150
chan,41,2,81,312,50,12277,362,6150
chan,41,3,103,290,61,12266,351,6150
chan,41,4,121,272,69,12258,341,6150
chan,41,5,129,264,67,12260,331,6150
chan,41,6,137,256,67,12260,323,6150
chan,41,7,128,265,70,12257,335,6150
chan,41,8,127,266,64,12263,330,6150
chan,41,9,130,263,46,12281,309,6150
chan,41,10,129,264,44,12283,308,6150
chan,41,11,131,262,42,12285,304,6150
chan,41,12,134,259,36,12291,295,6150
chan,41,13,133,260,34,12293,294,6150
chan,41,14,136,257,27,12300,284,6150
chan,41,15,139,254,21,12306,275,6150
chan,41,16,143,250,20,12307,270,6150
chan,41,17,142,251,21,12306,272,6150
chan,41,18,144,249,20,12307,269,6150
chan,41,19,144,249,20,12307,269,6150
chan,41,20,145,248,18,12309,266,6150
chan,41,21,149,244,15,12312,259,6150
chan,41,22,150,243,12,12315,255,6150
chan,41,23,150,243,11,12316,254,6150
chan,41,24,149,244,12,12315,256,6150
chan,41,25,151,242,10,12317,252,6150
chan,41,26,148,245,12,12315,257,6150
chan,41,27,148,245,12,12315,257,6150
chan,41,28,147,246,13,12314,259,6150
chan,41,29,146,247,13,12314,260,6150
chan,41,30,145,248,14,12313,262,6150
chan,41,31,147,246,13,12314,259,6150
chan,41,32,148,245,11,12316,256,6150
chan,41,33,150,243,9,12318,252,6150
chan,41,34,150,243,9,12318,252,6150
chan,41,35,149,244,10,12317,254,6150
chan,41,36,151,242,8,12319,250,6150
chan,41,37,151,242,8,12319,250,6150
chan,41,38,151,242,8,12319,250,6150
chan,41,39,152,241,7,12320,248,6150
chan,41,40,151,242,8,12319,250,6150
chan,41,41,152,241,7,12320,248,6150
chan,41,42,152,241,7,12320,248,6150
chan,41,43,152,241,7,12320,248,6150
chan,41,44,153,240,6,12321,246,6150
chan,41,45,153,240,6,12321,246,6150
chan,41,46,153,240,6,12321,246,6150
chan,41,47,152,241,7,12320,248,6150
chan,41,48,152,241,7,12320,248,6150
chan,41,49,152,241,7,12320,248,6150
chan,41,50,152,241,7,12320,248,6150
chan,42,1,63,330,23,12304,353,6300
chan,42,2,94,299,48,12279,347,6300
chan,42,3,112,281,59,12268,340,6300
chan,42,4,124,269,60,12267,329,6300
chan,42,5,123,270,79,12248,349,6300
chan,42,6,128,265,64,12263,329,6300
chan,42,7,129,264,56,12271,320,6300
chan,42,8,125,268,55,12272,323,6300
chan,42,9,123,270,51,12276,321,6300
chan,42,10,125,268,47,12280,315,6300
chan,42,11,128,265,41,12286,306,6300
chan,42,12,135,258,30,12297,288,6300
chan,42,13,142,251,23,12304,274,6300
chan,42,14,140,253,22,12305,275,6300
chan,42,15,143,250,21,12306,271,6300
chan,42,16,142,251,21,12306,272,6300
chan,42,17,143,250,19,12308,269,6300
chan,42,18,144,249,20,12307,269,6300
chan,42,19,145,248,17,12310,265,6300
chan,42,20,143,250,19,12308,269,6300
chan,42,21,143,250,18,12309,268,6300
chan,42,22,144,249,17,12310,266,6300
chan,42,23,145,248,16,12311,264,6300
chan,42,24,145,248,15,12312,263,6300
chan,42,25,146,247,14,12313,261,6300
chan,42,26,145,248,15,12312,263,6300
chan,42,27,145,248,15,12312,263,6300
chan,42,28,147,246,13,12314,259,6300
chan,42,29,147,246,13,12314,259,6300
chan,42,30,149,244,11,12316,255,6300
chan,42,31,151,242,9,12318,251,6300
chan,42,32,151,242,9,12318,251,6300
chan,42,33,151,242,9,12318,251,6300
chan,42,34,151,242,9,12318,251,6300
chan,42,35,152,241,8,12319,249,6300
chan,42,36,153,240,7,12320,247,6300
chan,42,37,153,240,7,12320,247,6300
chan,42,38,152,241,8,12319,249,6300
chan,42,39,152,241,8,12319,249,6300
chan,42,40,154,239,6,12321,245,6300
chan,42,41,154,239,5,12322,244,6300
chan,42,42,154,239,5,12322,244,6300
chan,42,43,154,239,5,12322,244,6300
chan,42,44,155,238,4,12323,242,6300
chan,42,45,155,238,4,12323,242,6300
chan,42,46,155,238,4,12323,242,6300
chan,42,47,154,239,5,12322,244,6300
chan,42,48,155,238,4,12323,242,6300
chan,42,49,157,236,2,12325,238,6300
chan,42,50,156,237,3,12324,240,6300
chan,43,1,48,345,23,12304,368,6450
chan,43,2,75,318,47,12280,365,6450
chan,43,3,106,287,55,12272,342,6450
chan,43,4,123,270,58,12269,328,6450
chan,43,5,128,265,62,12265,327,6450
chan,43,6,125,268,67,12260,335,6450
chan,43,7,125,268,64,12263,332,6450
chan,43,8,130,263,52,12275,315,6450
chan,43,9,131,262,40,12287,302,6450
chan,43,10,133,260,38,12289,298,6450
chan,43,11,133,260,37,12290,297,6450
chan,43,12,132,261,39,12288,300,6450
chan,43,13,130,263,36,12291,299,6450
chan,43,14,134,259,31,12296,290,6450
chan,43,15,133,260,33,12294,293,6450
chan,43,16,137,256,27,12300,283,6450
chan,43,17,137,256,30,12297,286,6450
chan,43,18,137,256,29,12298,285,6450
chan,43,19,141,252,25,12302,277,6450
chan,43,20,146,247,22,12305,269,6450
chan,43,21,145,248,21,12306,269,6450
chan,43,22,146,247,22,12305,269,6450
chan,43,23,144,249,20,12307,269,6450
chan,43,24,145,248,20,12307,268,6450
chan,43,25,146,247,16,12311,263,6450
chan,43,26,146,247,15,12312,262,6450
chan,43,27,147,246,15,12312,261,6450
chan,43,28,148,245,14,12313,259,6450
chan,43,29,149,244,11,12316,255,6450
chan,43,30,149,244,13,12314,257,6450
chan,43,31,149,244,13,12314,257,6450
chan,43,32,149,244,11,12316,255,6450
chan,43,33,150,243,10,12317,253,6450
chan,43,34,151,242,10,12317,252,6450
chan,43,35,151,242,10,12317,252,6450
chan,43,36,151,242,9,12318,251,6450
chan,43,37,151,242,8,12319,250,6450
chan,43,38,150,243,9,12318,252,6450
chan,43,39,150,243,9,12318,252,6450
chan,43,40,150,243,9,12318,252,6450
chan,43,41,150,243,9,12318,252,6450
chan,43,42,149,244,10,12317,254,6450
chan,43,43,149,244,10,12317,254,6450
chan,43,44,150,243,9,12318,252,6450
chan,43,45,151,242,9,12318,251,6450
chan,43,46,151,242,9,12318,251,6450
chan,43,47,151,242,9,12318,251,6450
chan,43,48,150,243,9,12318,252,6450
chan,43,49,151,242,9,12318,251,6450
chan,43,50,152,241,8,12319,249,6450
chan,44,1,65,328,24,12303,352,6600
chan,44,2,86,307,48,12279,355,6600
chan,44,3,100,293,55,12272,348,6600
chan,44,4,111,282,64,12263,346,6600
chan,44,5,116,277,73,12254,350,6600
chan,44,6,131,262,59,12268,321,6600
chan,44,7,128,265,54,12273,319,6600
chan,44,8,128,265,57,12270,322,6600
chan,44,9,129,264,55,12272,319,6600
chan,44,10,131,262,56,12271,318,6600
chan,44,11,132,261,52,12275,313,6600
chan,44,12,134,259,46,12281,305,6600
chan,44,13,136,257,43,12284,300,6600
chan,44,14,138,255,39,12288,294,6600
chan,44,15,142,251,35,12292,286,6600
chan,44,16,141,252,31,12296,283,6600
chan,44,17,143,250,23,12304,273,6600
chan,44,18,144,249,21,12306,270,6600
chan,44,19,144,249,21,12306,270,6600
chan,44,20,144,249,20,12307,269,6600
chan,44,21,145,248,16,12311,264,6600
chan,44,22,143,250,17,12310,267,6600
chan,44,23,143,250,16,12311,266,6600
chan,44,24,145,248,15,12312,263,6600
chan,44,25,143,250,17,12310,267,6600
chan,44,26,145,248,14,12313,262,6600
chan,44,27,144,249,15,12312,264,6600
chan,44,28,147,246,12,12315,258,6600
chan,44,29,149,244,10,12317,254,6600
chan,44,30,149,244,10,12317,254,6600
chan,44,31,149,244,10,12317,254,6600
chan,44,32,150,243,9,12318,252,6600
chan,44,33,150,243,9,12318,252,6600
chan,44,34,150,243,9,12318,252,6600
chan,44,35,149,244,10,12317,254,6600
chan,44,36,151,242,9,12318,251,6600
chan,44,37,149,244,10,12317,254,6600
chan,44,38,148,245,11,12316,256,6600
chan,44,39,148,245,11,12316,256,6600
chan,44,40,148,245,12,12315,257,6600
chan,44,41,148,245,12,12315,257,6600
chan,44,42,149,244,11,12316,255,6600
chan,44,43,151,242,8,12319,250,6600
chan,44,44,152,241,7,12320,248,6600
chan,44,45,152,241,7,12320,248,6600
chan,44,46,153,240,6,12321,246,6600
chan,44,47,153,240,6,12321,246,6600
chan,44,48,153,240,6,12321,246,6600
chan,44,49,153,240,6,12321,246,6600
chan,44,50,153,240,6,12321,246,6600
chan,45,1,61,332,26,12301,358,6750
chan,45,2,87,306,40,12287,346,6750
chan,45,3,107,286,61,12266,347,6750
chan,45,4,112,281,72,12255,353,6750
chan,45,5,110,283,69,12258,352,6750
chan,45,6,120,273,72,12255,345,6750
chan,45,7,129,264,76,12251,340,6750
chan,45,8,134,259,68,12259,327,6750
chan,45,9,133,260,59,12268,319,6750
chan,45,10,131,262,54,12273,316,6750
chan,45,11,129,264,54,12273,318,6750
chan,45,12,135,258,51,12276,309,6750
chan,45,13,137,256,36,12291,292,6750
chan,45,14,138,255,36,12291,291,6750
chan,45,15,138,255,32,12295,287,6750
chan,45,16,141,252,29,12298,281,6750
chan,45,17,149,244,20,12307,264,6750
chan,45,18,147,246,22,12305,268,6750
chan,45,19,146,247,22,12305,269,6750
chan,45,20,147,246,16,12311,262,6750
chan,45,21,146,247,15,12312,262,6750
chan,45,22,146,247,14,12313,261,6750
chan,45,23,145,248,14,12313,262,6750
chan,45,24,145,248,14,12313,262,6750
chan,45,25,146,247,14,12313,261,6750
chan,45,26,147,246,13,12314,259,6750
chan,45,27,147,246,14,12313,260,6750
chan,45,28,147,246,14,12313,260,6750
chan,45,29,147,246,15,12312,261,6750
chan,45,30,148,245,16,12311,261,6750
chan,45,31,150,243,16,12311,259,6750
chan,45,32,150,243,14,12313,257,6750
chan,45,33,150,243,14,12313,257,6750
chan,45,34,150,243,13,12314,256,6750
chan,45,35,151,242,12,12315,254,6750
chan,45,36,153,240,7,12320,247,6750
chan,45,37,154,239,6,12321,245,6750
chan,45,38,154,239,6,12321,245,6750
chan,45,39,154,239,6,12321,245,6750
chan,45,40,154,239,6,12321,245,6750
chan,45,41,155,238,5,12322,243,6750
chan,45,42,155,238,5,12322,243,6750
chan,45,43,155,238,5,12322,243,6750
chan,45,44,155,238,4,12323,242,6750
chan,45,45,155,238,4,12323,242,6750
chan,45,46,155,238,4,12323,242,6750
chan,45,47,157,236,2,12325,238,6750
chan,45,48,157,236,2,12325,238,6750
chan,45,49,157,236,2,12325,238,6750
chan,45,50,157,236,2,12325,238,6750
chan,46,1,73,320,23,12304,343,6900
chan,46,2,105,288,38,12289,326,6900
chan,46,3,123,270,65,12262,335,6900
chan,46,4,132,261,69,12258,330,6900
chan,46,5,130,263,61,12266,324,6900
chan,46,6,137,256,52,12275,308,6900
chan,46,7,138,255,40,12287,295,6900
chan,46,8,138,255,40,12287,295,6900
chan,46,9,140,253,36,12291,289,6900
chan,46,10,142,251,32,12295,283,6900
chan,46,11,145,248,25,12302,273,6900
chan,46,12,141,252,26,12301,278,6900
chan,46,13,141,252,22,12305,274,6900
chan,46,14,144,249,21,12306,270,6900
chan,46,15,146,247,18,12309,265,6900
chan,46,16,146,247,19,12308,266,6900
chan,46,17,148,245,17,12310,262,6900
chan,46,18,150,243,15,12312,258,6900
chan,46,19,148,245,17,12310,262,6900
chan,46,20,149,244,16,12311,260,6900
chan,46,21,146,247,17,12310,264,6900
chan,46,22,147,246,17,12310,263,6900
chan,46,23,147,246,18,12309,264,6900
chan,46,24,148,245,19,12308,264,6900
chan,46,25,149,244,21,12306,265,6900
chan,46,26,149,244,20,12307,264,6900
chan,46,27,147,246,20,12307,266,6900
chan,46,28,146,247,21,12306,268,6900
chan,46,29,148,245,13,12314,258,6900
chan,46,30,149,244,12,12315,256,6900
chan,46,31,149,244,12,12315,256,6900
chan,46,32,150,243,10,12317,253,6900
chan,46,33,152,241,9,12318,250,6900
chan,46,34,152,241,10,12317,251,6900
chan,46,35,152,241,7,12320,248,6900
chan,46,36,153,240,8,12319,248,6900
chan,46,37,151,242,9,12318,251,6900
chan,46,38,151,242,9,12318,251,6900
chan,46,39,151,242,9,12318,251,6900
chan,46,40,152,241,8,12319,249,6900
chan,46,41,153,240,7,12320,247,6900
chan,46,42,151,242,9,12318,251,6900
chan,46,43,151,242,9,12318,251,6900
chan,46,44,151,242,8,12319,250,6900
chan,46,45,151,242,8,12319,250,6900
chan,46,46,151,242,8,12319,250,6900
chan,46,47,151,242,8,12319,250,6900
chan,46,48,152,241,7,12320,248,6900
chan,46,49,153,240,6,12321,246,6900
chan,46,50,153,240,6,12321,246,6900
chan,47,1,55,338,40,12287,378,7050
chan,47,2,79,314,50,12277,364,7050
chan,47,3,99,294,60,12267,354,7050
chan,47,4,110,283,71,12256,354,7050
chan,47,5,115,278,78,12249,356,7050
chan,47,6,119,274,77,12250,351,7050
chan,47,7,118,275,67,12260,342,7050
chan,47,8,118,275,64,12263,339,7050
chan,47,9,123,270,57,12270,327,7050
chan,47,10,125,268,50,12277,318,7050
chan,47,11,130,263,41,12286,304,7050
chan,47,12,130,263,41,12286,304,7050
chan,47,13,130,263,40,12287,303,7050
chan,47,14,135,258,30,12297,288,7050
chan,47,15,137,256,28,12299,284,7050
chan,47,16,132,261,31,12296,292,7050
chan,47,17,133,260,33,12294,293,7050
chan,47,18,137,256,27,12300,283,7050
chan,47,19,136,257,28,12299,285,7050
chan,47,20,136,257,26,12301,283,7050
chan,47,21,136,257,24,12303,281,7050
chan,47,22,137,256,24,12303,280,7050
chan,47,23,140,253,21,12306,274,7050
chan,47,24,139,254,25,12302,279,7050
chan,47,25,140,253,23,12304,276,7050
chan,47,26,142,251,19,12308,270,7050
chan,47,27,142,251,19,12308,270,7050
chan,47,28,143,250,17,12310,267,7050
chan,47,29,146,247,15,12312,262,7050
chan,47,30,148,245,11,12316,256,7050
chan,47,31,149,244,10,12317,254,7050
chan,47,32,149,244,10,12317,254,7050
chan,47,33,152,241,8,12319,249,7050
chan,47,34,152,241,8,12319,249,7050
chan,47,35,151,242,9,12318,251,7050
chan,47,36,150,243,10,12317,253,7050
chan,47,37,150,243,9,12318,252,7050
chan,47,38,151,242,8,12319,250,7050
chan,47,39,151,242,8,12319,250,7050
chan,47,40,151,242,8,12319,250,7050
chan,47,41,152,241,7,12320,248,7050
chan,47,42,152,241,7,12320,248,7050
chan,47,43,151,242,8,12319,250,7050
chan,47,44,152,241,7,12320,248,7050
chan,47,45,152,241,7,12320,248,7050
chan,47,46,153,240,6,12321,246,7050
chan,47,47,153,240,6,12321,246,7050
chan,47,48,155,238,5,12322,243,7050
chan,47,49,154,239,5,12322,244,7050
chan,47,50,154,239,5,12322,244,7050
chan,48,1,51,342,32,12295,374,7200
chan,48,2,80,313,48,12279,361,7200
chan,48,3,100,293,60,12267,353,7200
chan,48,4,114,279,64,12263,343,7200
chan,48,5,121,272,64,12263,336,7200
chan,48,6,124,269,75,12252,344,7200
chan,48,7,127,266,68,12259,334,7200
chan,48,8,123,270,60,12267,330,7200
chan,48,9,127,266,60,12267,326,7200
chan,48,10,132,261,51,12276,312,7200
chan,48,11,130,263,49,12278,312,7200
chan,48,12,133,260,43,12284,303,7200
chan,48,13,134,259,38,12289,297,7200
chan,48,14,136,257,35,12292,292,7200
chan,48,15,135,258,31,12296,289,7200
chan,48,16,134,259,31,12296,290,7200
chan,48,17,133,260,32,12295,292,7200
chan,48,18,134,259,33,12294,292,7200
chan,48,19,136,257,30,12297,287,7200
chan,48,20,137,256,24,12303,280,7200
chan,48,21,139,254,22,12305,276,7200
chan,48,22,143,250,21,12306,271,7200
chan,48,23,142,251,21,12306,272,7200
chan,48,24,144,249,20,12307,269,7200
chan,48,25,147,246,17,12310,263,7200
chan,48,26,151,242,10,12317,252,7200
chan,48,27,151,242,10,12317,252,7200
chan,48,28,149,244,12,12315,256,7200
chan,48,29,149,244,10,12317,254,7200
chan,48,30,149,244,10,12317,254,7200
chan,48,31,147,246,12,12315,258,7200
chan,48,32,148,245,11,12316,256,7200
chan,48,33,148,245,11,12316,256,7200
chan,48,34,150,243,10,12317,253,7200
chan,48,35,150,243,9,12318,252,7200
chan,48,36,150,243,9,12318,252,7200
chan,48,37,150,243,9,12318,252,7200
chan,48,38,150,243,9,12318,252,7200
chan,48,39,151,242,8,12319,250,7200
chan,48,40,151,242,9,12318,251,7200
chan,48,41,151,242,8,12319,250,7200
chan,48,42,153,240,6,12321,246,7200
chan,48,43,153,240,6,12321,246,7200
chan,48,44,153,240,6,12321,246,7200
chan,48,45,152,241,7,12320,248,7200
chan,48,46,153,240,6,12321,246,7200
chan,48,47,153,240,6,12321,246,7200
chan,48,48,154,239,5,12322,244,7200
chan,48,49,154,239,5,12322,244,7200
chan,48,50,154,239,5,12322,244,7200
chan,49,1,62,331,27,12300,358,7350
chan,49,2,92,301,52,12275,353,7350
chan,49,3,110,283,52,12275,335,7350
chan,49,4,113,280,67,12260,347,7350
chan,49,5,118,275,72,12255,347,7350
chan,49,6,119,274,76,12251,350,7350
chan,49,7,121,272,68,12259,340,7350
chan,49,8,126,267,61,12266,328,7350
chan,49,9,127,266,50,12277,316,7350
chan,49,10,129,264,49,12278,313,7350
chan,49,11,133,260,47,12280,307,7350
chan,49,12,136,257,44,12283,301,7350
chan,49,13,140,253,37,12290,290,7350
chan,49,14,141,252,36,12291,288,7350
chan,49,15,139,254,36,12291,290,7350
chan,49,16,139,254,37,12290,291,7350
chan,49,17,137,256,30,12297,286,7350
chan,49,18,137,256,31,12296,287,7350
chan,49,19,140,253,26,12301,279,7350
chan,49,20,143,250,20,12307,270,7350
chan,49,21,147,246,16,12311,262,7350
chan,49,22,148,245,15,12312,260,7350
chan,49,23,148,245,15,12312,260,7350
chan,49,24,148,245,13,12314,258,7350
chan,49,25,147,246,14,12313,260,7350
chan,49,26,148,245,12,12315,257,7350
chan,49,27,148,245,11,12316,256,7350
chan,49,28,147,246,12,12315,258,7350
chan,49,29,149,244,10,12317,254,7350
chan,49,30,150,243,9,12318,252,7350
chan,49,31,150,243,9,12318,252,7350
chan,49,32,151,242,8,12319,250,7350
chan,49,33,151,242,8,12319,250,7350
chan,49,34,151,242,8,12319,250,7350
chan,49,35,152,241,8,12319,249,7350
chan,49,36,153,240,7,12320,247,7350
chan,49,37,152,241,7,12320,248,7350
chan,49,38,151,242,8,12319,250,7350
chan,49,39,151,242,8,12319,250,7350
chan,49,40,152,241,7,12320,248,7350
chan,49,41,153,240,6,12321,246,7350
chan,49,42,154,239,5,12322,244,7350
chan,49,43,154,239,5,12322,244,7350
chan,49,44,154,239,5,12322,244,7350
chan,49,45,154,239,5,12322,244,7350
chan,49,46,154,239,5,12322,244,7350
chan,49,47,154,239,5,12322,244,7350
chan,49,48,154,239,5,12322,244,7350
chan,49,49,154,239,5,12322,244,7350
chan,49,50,155,238,4,12323,242,7350
uinvite,0,1,71,322,19,12308,341,0
uinvite,0,2,94,299,32,12295,331,0
uinvite,0,3,107,286,41,12286,327,0
uinvite,0,4,106,287,45,12282,332,0
uinvite,0,5,111,282,44,12283,326,0
uinvite,0,6,101,292,44,12283,336,0
uinvite,0,7,106,287,44,12283,331,0
uinvite,0,8,101,292,38,12289,330,0
uinvite,0,9,109,284,36,12291,320,0
uinvite,0,10,111,282,35,12292,317,0
uinvite,0,11,109,284,31,12296,315,0
uinvite,0,12,105,288,33,12294,321,0
uinvite,0,13,97,296,27,12300,323,0
uinvite,0,14,102,291,23,12304,314,0
uinvite,0,15,101,292,24,12303,316,0
uinvite,0,16,103,290,25,12302,315,0
uinvite,0,17,105,288,27,12300,315,0
uinvite,0,18,103,290,25,12302,315,0
uinvite,0,19,104,289,21,12306,310,0
uinvite,0,20,103,290,18,12309,308,0
uinvite,0,21,105,288,17,12310,305,0
uinvite,0,22,104,289,15,12312,304,0
uinvite,0,23,108,285,15,12312,300,0
uinvite,0,24,107,286,15,12312,301,0
uinvite,0,25,111,282,10,12317,292,0
uinvite,0,26,105,288,8,12319,296,0
uinvite,0,27,100,293,13,12314,306,0
uinvite,0,28,103,290,9,12318,299,0
uinvite,0,29,105,288,11,12316,299,0
uinvite,0,30,105,288,10,12317,298,0
uinvite,0,31,100,293,9,12318,302,0
uinvite,0,32,102,291,7,12320,298,0
uinvite,0,33,105,288,8,12319,296,0
uinvite,0,34,103,290,7,12320,297,0
uinvite,0,35,108,285,7,12320,292,0
uinvite,0,36,103,290,7,12320,297,0
uinvite,0,37,107,286,8,12319,294,0
uinvite,0,38,106,287,8,12319,295,0
uinvite,0,39,105,288,6,12321,294,0
uinvite,0,40,107,286,4,12323,290,0
uinvite,0,41,105,288,4,12323,292,0
uinvite,0,42,107,286,4,12323,290,0
uinvite,0,43,107,286,4,12323,290,0
uinvite,0,44,102,291,2,12325,293,0
uinvite,0,45,106,287,3,12324,290,0
uinvite,0,46,107,286,3,12324,289,0
uinvite,0,47,104,289,2,12325,291,0
uinvite,0,48,107,286,2,12325,288,0
uinvite,0,49,103,290,2,12325,292,0
uinvite,0,50,103,290,1,12326,291,0
uinvite-halfa,0,1,71,322,19,12308,341,0
uinvite-halfa,0,2,120,273,47,12280,320,0
uinvite-halfa,0,3,146,247,64,12263,311,0
uinvite-halfa,0,4,158,235,83,12244,318,0
uinvite-halfa,0,5,167,226,80,12247,306,0
uinvite-halfa,0,6,161,232,83,12244,315,0
uinvite-halfa,0,7,168,225,76,12251,301,0
uinvite-halfa,0,8,177,216,83,12244,299,0
uinvite-halfa,0,9,186,207,88,12239,295,0
uinvite-halfa,0,10,194,199,76,12251,275,0
uinvite-halfa,0,11,198,195,70,12257,265,0
uinvite-halfa,0,12,198,195,66,12261,261,0
uinvite-halfa,0,13,199,194,60,12267,254,0
uinvite-halfa,0,14,195,198,56,12271,254,0
uinvite-halfa,0,15,203,190,59,12268,249,0
uinvite-halfa,0,16,211,182,62,12265,244,0
uinvite-halfa,0,17,207,186,58,12269,244,0
uinvite-halfa,0,18,210,183,57,12270,240,0
uinvite-halfa,0,19,212,181,56,12271,237,0
uinvite-halfa,0,20,203,190,53,12274,243,0
uinvite-halfa,0,21,212,181,50,12277,231,0
uinvite-halfa,0,22,225,168,41,12286,209,0
uinvite-halfa,0,23,224,169,45,12282,214,0
uinvite-halfa,0,24,230,163,40,12287,203,0
uinvite-halfa,0,25,229,164,42,12285,206,0
uinvite-halfa,0,26,228,165,32,12295,197,0
uinvite-halfa,0,27,226,167,34,12293,201,0
uinvite-halfa,0,28,228,165,28,12299,193,0
uinvite-halfa,0,29,229,164,27,12300,191,0
uinvite-halfa,0,30,231,162,26,12301,188,0
uinvite-halfa,0,31,226,167,25,12302,192,0
uinvite-halfa,0,32,232,161,23,12304,184,0
uinvite-halfa,0,33,236,157,22,12305,179,0
uinvite-halfa,0,34,240,153,24,12303,177,0
uinvite-halfa,0,35,247,146,24,12303,170,0
uinvite-halfa,0,36,245,148,25,12302,173,0
uinvite-halfa,0,37,245,148,26,12301,174,0
uinvite-halfa,0,38,252,141,26,12301,167,0
uinvite-halfa,0,39,245,148,25,12302,173,0
uinvite-halfa,0,40,245,148,20,12307,168,0
uinvite-halfa,0,41,246,147,23,12304,170,0
uinvite-halfa,0,42,250,143,24,12303,167,0
uinvite-halfa,0,43,247,146,21,12306,167,0
uinvite-halfa,0,44,244,149,25,12302,174,0
uinvite-halfa,0,45,248,145,18,12309,163,0
uinvite-halfa,0,46,246,147,24,12303,171,0
uinvite-halfa,0,47,251,142,18,12309,160,0
uinvite-halfa,0,48,251,142,20,12307,162,0
uinvite-halfa,0,49,243,150,18,12309,168,0
uinvite-halfa,0,50,252,141,18,12309,159,0
uinvite-halfa,1,1,65,328,26,12301,354,150
uinvite-halfa,1,2,114,279,49,12278,328,150
uinvite-halfa,1,3,145,248,77,12250,325,150
uinvite-halfa,1,4,165,228,93,12234,321,150
uinvite-halfa,1,5,160,233,100,12227,333,150
uinvite-halfa,1,6,164,229,108,12219,337,150
uinvite-halfa,1,7,173,220,106,12221,326,150
uinvite-halfa,1,8,170,223,112,12215,335,150
uinvite-halfa,1,9,179,214,108,12219,322,150
uinvite-halfa,1,10,183,210,102,12225,312,150
uinvite-halfa,1,11,188,205,98,12229,303,150
uinvite-halfa,1,12,187,206,93,12234,299,150
uinvite-halfa,1,13,198,195,91,12236,286,150
uinvite-halfa,1,14,190,203,89,12238,292,150
uinvite-halfa,1,15,203,190,79,12248,269,150
uinvite-halfa,1,16,206,187,71,12256,258,150
uinvite-halfa,1,17,218,175,71,12256,246,150
uinvite-halfa,1,18,215,178,73,12254,251,150
uinvite-halfa,1,19,210,183,68,12259,251,150
uinvite-halfa,1,20,223,170,64,12263,234,150
uinvite-halfa,1,21,232,161,58,12269,219,150
uinvite-halfa,1,22,231,162,46,12281,208,150
uinvite-halfa,1,23,234,159,48,12279,207,150
uinvite-halfa,1,24,229,164,50,12277,214,150
uinvite-halfa,1,25,225,168,41,12286,209,150
uinvite-halfa,1,26,231,162,48,12279,210,150
uinvite-halfa,1,27,230,163,42,12285,205,150
uinvite-halfa,1,28,231,162,37,12290,199,150
uinvite-halfa,1,29,237,156,32,12295,188,150
uinvite-halfa,1,30,234,159,28,12299,187,150
uinvite-halfa,1,31,234,159,31,12296,190,150
uinvite-halfa,1,32,241,152,27,12300,179,150
uinvite-halfa,1,33,244,149,34,12293,183,150
uinvite-halfa,1,34,248,145,32,12295,177,150
uinvite-halfa,1,35,250,143,33,12294,176,150
uinvite-mixture,0,1,0,393,0,12327,393,0
uinvite-mixture,0,2,13,380,0,12327,380,0
uinvite-mixture,0,3,36,357,0,12327,357,0
uinvite-mixture,0,4,60,333,2,12325,335,0
uinvite-mixture,0,5,86,307,4,12323,311,0
uinvite-mixture,0,6,104,289,4,12323,293,0
uinvite-mixture,0,7,130,263,5,12322,268,0
uinvite-mixture,0,8,151,242,8,12319,250,0
uinvite-mixture,0,9,171,222,10,12317,232,0
uinvite-mixture,0,10,195,198,14,12313,212,0
uinvite-mixture,0,11,218,175,18,12309,193,0
uinvite-mixture,0,12,236,157,24,12303,181,0
uinvite-mixture,0,13,251,142,30,12297,172,0
uinvite-mixture,0,14,269,124,36,12291,160,0
uinvite-mixture,0,15,286,107,43,12284,150,0
uinvite-mixture,0,16,301,92,43,12284,135,0
uinvite-mixture,0,17,309,84,51,12276,135,0
uinvite-mixture,0,18,317,76,57,12270,133,0
uinvite-mixture,0,19,328,65,62,12265,127,0
uinvite-mixture,0,20,332,61,67,12260,128,0
uinvite-mixture,0,21,338,55,75,12252,130,0
uinvite-mixture,0,22,343,50,77,12250,127,0
uinvite-mixture,0,23,347,46,81,12246,127,0
uinvite-mixture,0,24,352,41,88,12239,129,0
uinvite-mixture,0,25,356,37,96,12231,133,0
uinvite-mixture,0,26,360,33,103,12224,136,0
uinvite-mixture,0,27,363,30,114,12213,144,0
uinvite-mixture,0,28,367,26,117,12210,143,0
uinvite-mixture,0,29,371,22,123,12204,145,0
uinvite-mixture,0,30,372,21,131,12196,152,0
uinvite-mixture,0,31,374,19,140,12187,159,0
uinvite-mixture,0,32,377,16,143,12184,159,0
uinvite-mixture,0,33,378,15,151,12176,166,0
uinvite-mixture,0,34,379,14,161,12166,175,0
uinvite-mixture,0,35,380,13,169,12158,182,0
uinvite-mixture,0,36,381,12,173,12154,185,0
uinvite-new,0,1,71,322,19,12308,341,0
uinvite-new,0,2,126,267,49,12278,316,0
uinvite-new,0,3,151,242,64,12263,306,0
uinvite-new,0,4,160,233,81,12246,314,0
uinvite-new,0,5,166,227,82,12245,309,0
uinvite-new,0,6,159,234,83,12244,317,0
uinvite-new,0,7,166,227,78,12249,305,0
uinvite-new,0,8,172,221,84,12243,305,0
uinvite-new,0,9,183,210,85,12242,295,0
uinvite-new,0,10,186,207,75,12252,282,0
uinvite-new,0,11,187,206,70,12257,276,0
uinvite-new,0,12,190,203,66,12261,269,0
uinvite-new,0,13,182,211,63,12264,274.0,0
uinvite-new,0,14,177,216,60,12267,276.0,0
uinvite-new,0,15,175,218,59,12268,277.0,0
uinvite-new,0,16,179,214,58,12269,272.0,0
uinvite-new,0,17,175,218,56,12271,274.0,0
uinvite-new,0,18,175,218,56,12271,274.0,0
uinvite-new,0,19,173,220,54,12273,274.0,0
uinvite-new,0,20,171,222,47,12280,269.0,0
uinvite-new,0,21,171,222,47,12280,269.0,0
uinvite-new,0,22,177,216,44,12283,260.0,0
uinvite-new,0,23,177,216,42,12285,258.0,0
uinvite-new,0,24,176,217,34,12293,251.0,0
